A Lasco, Opera	Opera tam edita quam inedita		Johannes a Lasco, Opera tam edita quam inedita, hg. v. Abraham Kuyper, 2 Bde., Amsterdam-Den Haag 1866.
ABaslerRef	Aktensammlung zur Geschichte der Basler Reformation in den Jahren 1519 bis Anfang 1534		Aktensammlung zur Geschichte der Basler Reformation in den Jahren 1519 bis Anfang 1534, hg. v. Emil Dürr und Paul Roth, 6 Bde., Basel 1921-1950.
ABernerRef	Aktensammlung zur Geschichte der Berner Reformation 1521-1532		Aktensammlung zur Geschichte der Berner Reformation 1521-1532, hg. v. Rudolf Steck und Gustav Tobler, 2 Bde., Bern 1923.
ACO	Acta Conciliorum Oecumenicorum		Acta Conciliorum Oecumenicorum, hg. v. Eduard Schwartz, 4 Bde., Berlin 1914-1984; Serie 2, Berlin 1984ff.
ADB	Allgemeine Deutsche Biographie		Allgemeine Deutsche Biographie, 55 Bde., Leipzig 1875-1910; Registerband, München/Leipzig 1912.
ADRG	Akten der deutschen Reichsreligionsgespräche im 16. Jahrhundert		Akten der deutschen Reichsreligionsgespräche im 16. Jahrhundert, hg. v. Klaus Ganzer und Karl-Heinz zur Mühlen, Göttingen 2000ff.
AHVB	Archiv des Historischen Vereins des Kantons Bern		Archiv des Historischen Vereins des Kantons Bern, Bern 1855ff.
AL	Augustinus-Lexikon		Augustinus-Lexikon, hg. v. Cornelius P. Mayer, Basel 1994ff.
ARCEG	Acta reformationis catholicae ecclesiam Germaniae concernentia saeculi XVI.		Acta reformationis catholicae ecclesiam Germaniae concernentia saeculi XVI., hg. v. Georg Pfeilschifter, 6 Bde., Regensburg 1959-1974.
ARG	Archiv für Reformationsgeschichte	40	Archiv für Reformationsgeschichte, Bde. 1-40, Berlin 1903/04-1943 (Nachdruck: Vaduz 1964); Bd. 41, Tübingen 1948 (Nachdruck: Nendeln 1968); Bde. 42ff, Gütersloh 1951ff.
ASD (Erasmus)	Opera omnia Desiderii Erasmi Roterodami		Opera omnia Desiderii Erasmi Roterodami, Amsterdam 1969ff.
ASG	Anzeiger für schweizerische Geschichte		Anzeiger für schweizerische Geschichte, Bern 1870-1920.
ASchweizerRef (ASchweizer)	Actensammlung zur Schweizerischen Reformationsgeschichte in den Jahren 1521-1532, im Anschluß an die gleichzeitigen eidgenössischen Abschiede		Actensammlung zur Schweizerischen Reformationsgeschichte in den Jahren 1521-1532, im Anschluß an die gleichzeitigen eidgenössischen Abschiede bearb. und hg. v. Johannes Strickler, 5 Bde., Zürich 1878-1884 (Nachdruck: Zürich 1989).
AZürcherRef	Actensammlung zur Geschichte der Zürcher Reformation in den Jahren 1519-1533		Actensammlung zur Geschichte der Zürcher Reformation in den Jahren 1519-1533, hg. v. Emil Egli, Zürich 1879 (Nachdruck: Nieuwkoop 1973).
Adagia	ASD II/1-9		Erasmus, Adagia, ASD II/1-9, Amsterdam 1981-2005.
Adam, Elsass	Evangelische Kirchengeschichte der elsässischen Territorien bis zur Französischen Revolution		Johann Adam, Evangelische Kirchengeschichte der elsässischen Territorien bis zur Französischen Revolution, Straßburg 1928.
Adam, Inventaire	Inventaire des archives du chapitre de Saint-Thomas de Strasbourg		Jean Adam, Inventaire des archives du chapitre de Saint-Thomas de Strasbourg, Straßburg 1937.
Adam, Straßburg (Adam)	Evangelische Kirchengeschichte der Stadt Straßburg bis zur Französischen Revolution		Johann Adam, Evangelische Kirchengeschichte der Stadt Straßburg bis zur Französischen Revolution, Straßburg 1922.
Adelung	Grammatisch-kritisches Wörterbuch der Hochdeutschen Mundart		Johann Christoph Adelung, Grammatisch-kritisches Wörterbuch der Hochdeutschen Mundart, 4 Bde., Leipzig 1793-1801 (Nachdruck: Hildesheim 1990).
Allen (Erasmus, Corr.)	Opus epistolarum Des. Erasmi Roterodami		Opus epistolarum Des. Erasmi Roterodami, hg. v. Percy Stafford Allen und Helen Marym Allen in Zusammenarbeit mit Heathcote William Garrod, 12 Bde., Oxford 1906-1958.
Amerbach Korr.	Die Amerbachkorrespondenz		Die Amerbachkorrespondenz, hg. v. Alfred Hartmann, Beat Rudolf Jenny u.a., 11 Bde., Basel 1942-2010.
Amerbachs Werkstatt	Aus der Werkstatt der Amerbach-Edition. Christoph Vischer zum 90. Geburtstag		Ueli Dill und Beat R. Jenny (mit einem Beitrag von Alfred R. Weber), Aus der Werkstatt der Amerbach-Edition. Christoph Vischer zum 90. Geburtstag, Basel 2000.
Amico cuidam	Loci Communes		Vermigli Pietro Martire and Robertus MASSONIUS. 1576. Petri Martyris Vermilii ... Loci Communes. Ex Variis Ipsius Authoris Libris in Unum Volumen Collecti&Quatuor Classes Distributi. [Edited by R. Massonius.]. Londini: Ex typographia I. Kyngstoni.
Anshelm, Chronik (Anshelm)	Die Berner-Chronik des Valerius Anshelm		Die Berner-Chronik des Valerius Anshelm, hg. v. Historischen Verein des Kantons Bern, 6 Bde., Bern 1884-1901.
AppenzellWB (Koller/Signer)	Appenzellisches Wappen- und Geschlechterbuch		Appenzellisches Wappen- und Geschlechterbuch, hg. v. Ernst H. Koller und Jakob Signer, Bern/Aarau 1926.
Appenzeller Urk.	Appenzeller Urkundenbuch	2	Appenzeller Urkundenbuch, Bd. 2, bearb. v. Traugott Schieß, Trogen 1934.
Arbusow	Colores Rhetorici. Eine Auswahl rhetorischer Figuren und Gemeinplätze als Hilfsmittel für akademische Übungen an mittelalterlichen Texten		Leonid Arbusow, Colores Rhetorici. Eine Auswahl rhetorischer Figuren und Gemeinplätze als Hilfsmittel für akademische Übungen an mittelalterlichen Texten, hg. V. Helmut Peter, Göttingen 1963.
Aretino, Opere	Edizione nazionale delle opere di Pietro Aretino		Edizione nazionale delle opere di Pietro Aretino, Rom 1992ff.
Asmus, Magdeburg	1200 Jahre Magdeburg	1	Helmut Asmus, 1200 Jahre Magdeburg, Bd. 1: Die Jahre 805-1631, Magdeburg 2000.
Athenae rauricae	Athenae rauricae sive catalogus professorum Academiae Basiliensis		Athenae rauricae sive catalogus professorum Academiae Basiliensis, hg. v. [Johann Wilhelm Herzog], Basel 1778.
Augsburger Eliten	Augsburger Eliten des 16. Jahrhunderts. Prosopographie wirtschaftlicher und politischer Führungsgruppen 1500-1620		Augsburger Eliten des 16. Jahrhunderts. Prosopographie wirtschaftlicher und politischer Führungsgruppen 1500-1620, hg. v. Wolfgang Reinhard, bearb. v. Mark Häberlein, Ulrich Klinkert, Katarina Sieh-Burens und Reinhard Wendt, Berlin 1996.
Austro-Turcica	Austro-Turcica 1541-1552. Diplomatische Akten des habsburgischen Gesandtschaftsverkehrs mit der Hohen Pforte im Zeitalter Süleymans des Prächtigen		Austro-Turcica 1541-1552. Diplomatische Akten des habsburgischen Gesandtschaftsverkehrs mit der Hohen Pforte im Zeitalter Süleymans des Prächtigen, bearb. v. Srećko M. Džaja unter Mitarbeit von Günter Weiß, hg. v. Karl Nehring in Verbindung mit Mathias Bernath, München 1995 - Südosteuropäische Arbeiten 95.
BBA	Bibliotheca bibliographica Aureliana		Bibliotheca bibliographica Aureliana, Baden-Baden 1959ff.
BBKL	Biographisch-Bibliographisches Kirchenlexikon		Biographisch-Bibliographisches Kirchenlexikon, begründet und hg. v. Friedrich Wilhelm Bautz, fortgeführt von Traugott Bautz, Bd. 1-2, Hamm 1975/1990; Bd. 3-19, Herzberg 1992-2001; Bd. 20-36, Nordhausen 2002-2015.
BHR	Bibliothèque d'humanisme et Renaissance		Bibliothèque d'humanisme et Renaissance, Genf 1941ff.
BKS-Geheimschrift	Eine noch unbekannte Geheimschrift in der Korrespondenz zwischen Ambrosius Blarer und Heinrich Bullinger		Reinhard Bodenmann, Alexandra Kess und Judith Steiniger, Eine noch unbekannte Geheimschrift in der Korrespondenz zwischen Ambrosius Blarer und Heinrich Bullinger (1546-1553), in: ARG CIX, 2018, 413-427.
BNBelg	Biographie nationale publiée par l'Académie royale des sciences		Biographie nationale publiée par l'Académie royale des sciences, des lettres et des beaux-arts de Belgique, 28 Bde. und 16 Supplementbde., Brüssel 1866-1986.
BS	Berner Synodus mit den Schlußreden der Berner Disputation und dem Reformationsmandat		Berner Synodus mit den Schlußreden der Berner Disputation und dem Reformationsmandat, (übers. v. Markus Bieler), Bern 1978. - Dokumente der Berner Reformation.
BSHPF	Bulletin de la Société de l'histoire du protestantisme français		Bulletin de la Société de l'histoire du protestantisme français, Paris 1853ff.
BSLK	Die Bekenntnisschriften der evangelisch-lutherischen Kirche		Die Bekenntnisschriften der evangelisch-lutherischen Kirche, hg. im Gedenkjahr der Augsburgischen Konfession 1930, 12. Aufl., Göttingen 1999.
BSRK	Die Bekenntnisschriften der reformierten Kirche		Die Bekenntnisschriften der reformierten Kirche. In authentischen Texten mit geschichtlicher Einleitung und Register hg. v. Ernst Friedrich Karl Müller, Leipzig 1903 (Nachdruck: Zürich 1987).
BWKG	Blätter für Württembergische Kirchengeschichte		Blätter für Württembergische Kirchengeschichte, NF 1-47, Stuttgart 1897-1943; 3. Folge 48ff, Stuttgart 1948ff.
BZD (Vischer, BZD)	Bibliographie der Zürcher Druckschriften des 15. und 16. Jahrhunderts		Manfred Vischer, Bibliographie der Zürcher Druckschriften des 15. und 16. Jahrhunderts, Baden-Baden 1990 - BBA 124.
BZGA	Basler Zeitschrift für Geschichte und Altertumskunde		Basler Zeitschrift für Geschichte und Altertumskunde, Basel 1902ff.
Barge	Andreas Bodenstein von Karlstadt		Hermann Barge, Andreas Bodenstein von Karlstadt, I. Teil: Karlstadt und die Anfänge der Reformation; II. Teil: Karlstadt als Vorkämpfer des laienchristlichen Puritanismus, 2 Bde., Leipzig 1905 (Nachdruck: Nieuwkoop 1968).
Baum	Nach ihrem handschriftlichen Briefschatze, ihren gedruckten Schriften und anderen gleicchzeitigen Quellen		Johann Wilhelm Baum, Capito und Butzer, Straßburgs Reformatoren. Nach ihrem handschriftlichen Briefschatze, ihren gedruckten Schriften und anderen gleicchzeitigen Quellen, Elberfeld 1860. - LSRK III.
Belg. typ.	Belgica typographica		Belgica typographica, 1541-1600. Catalogus librorum impressorum ab anno MDXLI ad annum MDC in regionibus quae nunc Regni Belgarum partes sunt, bearb. v. Elly Cockx-Indestege (Bd. 1), Geneviève Glorieux (Bd. 1 bis 4) und Bart op de Beeck (Bd. 3 und 4), 4 Bde., Nieuwkoop 1968-1994.
Benzing, Buchdrucker	Die Buchdrucker des 16. und 17. Jahrhunderts im deutschen Sprachgebiet		Josef Benzing, Die Buchdrucker des 16. und 17. Jahrhunderts im deutschen Sprachgebiet, 2. Aufl., Wiesbaden 1982 - Beiträge zum Buch- und Bibliothekswesen 12.
Bernhard, Stephanskrone	Konsolidierung des reformierten Bekenntnisses im Reich der Stephanskrone. Ein Beitrag zur Kommunikationsgeschichte zwischen Ungarn und der Schweiz in der frühen Neuzeit		Jan-Andrea Bernhard, Konsolidierung des reformierten Bekenntnisses im Reich der Stephanskrone. Ein Beitrag zur Kommunikationsgeschichte zwischen Ungarn und der Schweiz in der frühen Neuzeit (1500-1700), Göttingen 2014 - Refo500 Academic Studies 19.
Bibliander Bibl. (Moser, Bibliander)	Annotierte Bibliographie der gedruckten Werke		Christian Moser, Theodor Bibliander (1505-1564). Annotierte Bibliographie der gedruckten Werke, Zürich 2009 - ZBRG 27.
Bibliographia Bucerana	Bibliographia Bucerana		Bibliographia Bucerana, unter Mitwirkung von Erwin Steinborn zusammengestellt und bearb. v. Robert Stupperich, in: SVRG LVIII/2 (Nr. 169), Gütersloh 1952, S. 37-96.
Bibliotheca Calviniana	Les oeuvres de Jean Calvin publiées au XVI. siècle		Rodolphe Peter und Jean-François Gilmont, Bibliotheca Calviniana. Les oeuvres de Jean Calvin publiées au XVI. siècle, 3 Bde., Genf 1991-2000 - THR 255. 281. 339.
Bibliotheca Erasmiana	Bibliotheca Erasmiana. Répertoire des Œuvres d’Erasme		Bibliotheca Erasmiana. Répertoire des Œuvres d’Erasme, 3 séries, Gent 1893 (Nachdruck: Nieuwkoop 1961).
Bibliotheca dissidentium	Bibliotheca dissidentium. Répertoire des non-conformistes religieux des seizième et dix-septièmes siècles		Bibliotheca dissidentium. Répertoire des non-conformistes religieux des seizième et dix-septièmes siècles, hg. v. André Séguenny in Zusammenarbeit mit Jean Rott; ab Bd. 24 hg. v. Martin Rothkegel, Baden-Baden/Bouxwiller 1980ff - BBA.
Bindseil	Philippi Melanchthonis epistolae, iudicia, consilia, testimonia aliorumque ad eum epistolae, quae in Corpore Reformatorum desiderantur		Philippi Melanchthonis epistolae, iudicia, consilia, testimonia aliorumque ad eum epistolae, quae in Corpore Reformatorum desiderantur, hg. v. Heinrich Ernst Bindseil, Halle a. d. Saale 1874 (Nachdruck: Hildesheim/New York 1975).
Bizer, Abendmahlsstreit	Studien zur Geschichte des Abendmahlsstreits im 16. Jahrhundert		Ernst Bizer, Studien zur Geschichte des Abendmahlsstreits im 16. Jahrhundert, Gütersloh 1940 (Nachdruck: Darmstadt 1962).
Blaise	Dictionnaire Latin-Français des auteurs chrétiens. Revu spécialement pour le vocabulaire théologique par Henri Chirat		Albert Blaise, Dictionnaire Latin-Français des auteurs chrétiens. Revu spécialement pour le vocabulaire théologique par Henri Chirat, Turnhout (1954).
Blanke	Der junge Bullinger		Fritz Blanke, Der junge Bullinger, 1504-1531. Mit Bilderbeilage bearb. v. Leo Weisz, Zürich (1942). – Zwingli-Bücherei 22.
Blarer BW	Briefwechsel der Brüder Ambrosius und Thomas Blaurer		Briefwechsel der Brüder Ambrosius und Thomas Blaurer, 1509-1567, bearb. v. Traugott Schieß, 3 Bde., Freiburg i. Br. 1908-1912.
Blarer-Gedenkschrift	Der Konstanzer Reformator Ambrosius Blarer 1492-1564. Gedenkschrift zu seinem 400. Todestag		Der Konstanzer Reformator Ambrosius Blarer 1492-1564. Gedenkschrift zu seinem 400. Todestag, hg. v. Bernd Moeller, Konstanz/Stuttgart 1964.
Blume, Goslar	Goslar und der Schmalkaldische Bund		Gundmar Blume, Goslar und der Schmalkaldische Bund 1527/31-1547, Goslar 1969 - Beiträge zur Geschichte der Stadt Goslar 26.
Bobzin, Koran	Der Koran im Zeitalter der Reformation. Studien zur Frühgeschichte der Arabistik und Islamkunde in Europa,		Hartmut Bobzin, Der Koran im Zeitalter der Reformation. Studien zur Frühgeschichte der Arabistik und Islamkunde in Europa, Habil. Erlangen/Nürnberg 1986, Stuttgart 1995 - Beiruter Texte und Studien 42.
Bodemer	Der Bannerhandel zwischen Appenzell und St. Gallen 1535-1539. Ein Beitrag zur Schweizerischen Kulturgeschichte des XVI. Jahrhunderts		Gottfried Bodemer, Der Bannerhandel zwischen Appenzell und St. Gallen 1535-1539. Ein Beitrag zur Schweizerischen Kulturgeschichte des XVI. Jahrhunderts, Diss. phil. Bern, St. Gallen 1905.
Bodenmann	Destin d'un autodidacte lorrain au siècle des Réformes		Reinhard Bodenmann, Wolfgang Musculus (1497-1563). Destin d'un autodidacte lorrain au siècle des Réformes, Genf 2000 - Travaux d'Humanisme et Renaissance 343.
Boehmer, Dryander	Francisci Dryandri, Hispani, epistolae quinquaginta		Francisci Dryandri, Hispani, epistolae quinquaginta, hg. v. Eduard Boehmer, in: Zeitschrift für die historische Theologie 40, 1870, S. 387-442.
Boesch, Gwalther (Boesch, Gwalthers Reise)	Rudolph Gwalthers Reise nach England im Jahr 1537		Paul Boesch, Rudolph Gwalthers Reise nach England im Jahr 1537, in: Zwa 8/8, 1947, 433-471.
Bonorand, Bündner Stud.	Bündner Studierende an höhern Schulen der Schweiz und des Auslandes im Zeitalter der Reformation und Gegenreformation		Conradin Bonorand, Bündner Studierende an höhern Schulen der Schweiz und des Auslandes im Zeitalter der Reformation und Gegenreformation, in: Jahresbericht der Historisch-Antiquarischen Gesellschaft von Graubünden 79, 1949, S. 89-174.
Bopp-I (Bopp; Bopp I)	Die evangelischen Geistlichen und Theologen in Elsaß und Lothringen von der Reformation bis zur Gegenwart		Marie-Joseph Bopp, Die evangelischen Geistlichen und Theologen in Elsaß und Lothringen von der Reformation bis zur Gegenwart, Neustadt a. d. Aisch 1959 - Genealogie und Landesgeschichte 1; Bibliothek familiengeschichtlicher Quellen 14.
Bopp-II (Bopp II)	Die evangelischen Gemeinden und Hohen Schulen in Elsaß und Lothringen von der Reformation bis zur Gegenwart		Marie-Joseph Bopp, Die evangelischen Gemeinden und Hohen Schulen in Elsaß und Lothringen von der Reformation bis zur Gegenwart, Neustadt a. d. Aisch 1963 - Genealogie und Landesgeschichte 5; Bibliothek familiengeschichtlicher Quellen 16.
Borsa, Siebenbürgen	Alte siebenbürgische Drucke (16. Jahrhundert)		Gedeon Borsa, Alte siebenbürgische Drucke (16. Jahrhundert), Böhlau 1996 - Schriften zur Landeskunde Siebenbürgens 21.
Bossert	Die württembergischen Kirchendiener bis 1556		Gustav Bossert, Die württembergischen Kirchendiener bis 1556, in: BWKG 9, 1905, 1-42.
Bosshart	Die Chronik des Laurencius Bosshart von Winterthur		Die Chronik des Laurencius Bosshart von Winterthur, 1185-1532, hg. v. Kaspar Hauser, Basel 1905. - QSRG III.
Bourquin, Biel	Stadtgeschichtliches Lexikon von der Römerzeit (Petinesca) bis Ende der 1930er Jahre		Werner und Marcus Bourquin, Biel. Stadtgeschichtliches Lexikon von der Römerzeit (Petinesca) bis Ende der 1930er Jahre, Biel 1999.
Bourrilly, Guillaume du Bellay	Guillaume du Bellay, seigneur de Langey		V.-L. Bourrilly, Guillaume du Bellay, seigneur de Langey, 1491-1543, Paris 1904.
Bourrilly/Weiss	Jean du Bellay, les Protestants et la Sorbonne		V.-L. Bourrilly et N. Weiss, Jean du Bellay, les Protestants et la Sorbonne (1529-1535), in: BSHPF 52, 1903, 193-231 und 53, 1904, 97-143.
Bouvier	Henri Bullinger, réformateur et conseiller œcuménique, le successeur de Zwingli, d'après sa correspondance avec les réformés et les humanistes de langue française, suivi de notes complémentaires et de XXVI lettres inédites en appendice		André Bouvier, Henri Bullinger, réformateur et conseiller œcuménique, le successeur de Zwingli, d'après sa correspondance avec les réformés et les humanistes de langue française, suivi de notes complémentaires et de XXVI lettres inédites en appendice, Neuchâtel/Paris 1940.
Brandi, Karl V. (Brandi)	Werden und Schicksal einer Persönlichkeit und eines Weltreiches		Karl Brandi, Kaiser Karl V. Werden und Schicksal einer Persönlichkeit und eines Weltreiches, 2 Bde., München 1937/1941.
Brecht, Blarer (Brecht; Brecht, Blarer in Schwaben)	Ambrosius Blarers Wirksamkeit in Schwaben, in: Der Konstanzer Reformator Ambrosius Blarer 1492-1564		Martin Brecht, Ambrosius Blarers Wirksamkeit in Schwaben, in: Der Konstanzer Reformator Ambrosius Blarer 1492-1564. Gedenkschrift zu seinem 400. Todestag, hg. v. Bernd Moeller, Konstanz/Stuttgart 1964, S. 140-171.
Briefe des Heidelberger Theologen Zacharias Ursinus (1534 bis 1583)	Heidelberger Jahrbücher	8	Benrath, G.A. (1964). Briefe des Heidelberger Theologen Zacharias Ursinus (1534–1583). In: Ernst, F. (eds) Heidelberger Jahrbücher. Heidelberger Jahrbücher, vol 8. Springer, Berlin, Heidelberg. https://doi.org/10.1007/978-3-642-46002-9_7
Brockmann	Die Konzilsfrage in den Flug- und Streitschriften des deutschen Sprachraumes 1518-1563		Thomas Brockmann, Die Konzilsfrage in den Flug- und Streitschriften des deutschen Sprachraumes 1518-1563, Göttingen 1998 - Schriftenreihe der Historischen Kommission bei der Bayerischen Akademie der Wissenschaften 57.
Bucer BW	Correspondance de Martin Bucer		Correspondance de Martin Bucer. Martin Bucer, Briefwechsel, hg. v. Jean Rott; ab Bd. 3 in Zusammenarbeit mit Christian Krieger u.a.; ab Bd. 4 hg. v. Reinhold Friedrich, Berndt Hamm, Wolfgang Simon u.a., Leiden 1979ff.
Bucer Bibl. (BucerBibl)	Bibliographie		Martin Bucer (1491-1551). Bibliographie, erstellt von Holger Pils, Stephan Ruderer und Petra Schaffrodt, hg. v. Gottfried Seebaß, Gütersloh 2005.
BucerDS	Martin Bucers Deutsche Schriften, im Auftrag der Heidelberger Akademie der Wissenschaften		Martin Bucers Deutsche Schriften, im Auftrag der Heidelberger Akademie der Wissenschaften hg. v. Robert Stupperich u.a., Gütersloh 1960ff.
BucerOL	Martini Buceri Opera Latina		Martini Buceri Opera Latina, Paris/Gütersloh 1954/55; Leiden 1982ff.
Bucher	Die Reformation in den Freien Ämtern und in der Stadt Bremgarten (bis 1531)		Adolf Bucher, Die Reformation in den Freien Ämtern und in der Stadt Bremgarten (bis 1531), Diss. phil. Freiburg/Schweiz, Sarnen 1950. – Beilage zum Jahresbericht der Kantonalen Lehranstalt Sarnen 1949-1950.
Bucholtz	Geschichte der Regierung Ferdinand des Ersten		Franz Bernhard von Bucholtz, Geschichte der Regierung Ferdinand des Ersten, 9 Bde., Wien 1831-1838 (Nachdruck: Graz 1968-1971).
Bullinger Digital	Digitale Erschliessung von Heinrich Bullingers Briefwechsel		Institut für Computerlinguistik und Institut für Schweizerische Reformationsgeschichte der Universität Zürich (Hrsg.): Bullinger Digital. Digitale Erschliessung von Heinrich Bullingers Briefwechsel. 2020-2022. www.bullinger-digital.ch/.
Bullinger, Testament (Bullinger, Pbrivates Testament)	Heinrich Bullingers privates Testament. Ein wiederentdecktes Selbstzeugnis des Reformators		Heinrich Bullingers privates Testament. Ein wiederentdecktes Selbstzeugnis des Reformators, hg. v. Rainer Henrich, in: ZTB 2010, NF 130, S. 1-40.
Bullinger, Tig. Chron.	Heinrich Bullinger, Tigurinerchronik		Heinrich Bullinger, Tigurinerchronik, hg. v. Hans Ulrich Bächtold, 3 Bde., Zürich 2018 - Heinrich Bullinger, Werke, 4. Abt.: Historische Schriften.
Burckhardt-Biedermann	Die Erneuerung der Universität zu Basel in den Jahren 1529-1539		Theophil Burckhardt-Biedermann, Die Erneuerung der Universität zu Basel in den Jahren 1529-1539, in: Beiträge zur vaterländischen Geschichte, hg. v. der Historischen und Antiquarischen Gesellschaft zu Basel, NF IV, 1892, S. 401-487.
Burmeister	Briefe Sebastian Münsters. Lateinisch und deutsch		Briefe Sebastian Münsters. Lateinisch und deutsch, hg. v. Karl Heinz Burmeister, Ingelheim am Rhein 1964.
Bächtold, Rat (Bächtold, Bullinger vor dem Rat)	Zur Gestaltung und Verwaltung des Zürcher Staatswesens in den Jahren 1531-1575		Hans Ulrich Bächtold, Heinrich Bullinger vor dem Rat. Zur Gestaltung und Verwaltung des Zürcher Staatswesens in den Jahren 1531-1575, Bern 1982 - ZBRG 12.
Bächtold, Schwurformel	"Das uns Gott helff und die Heiligen": Zürich im Streit um die eidgenössische Schwurformel		Hans Ulrich Bächtold, "Das uns Gott helff und die Heiligen": Zürich im Streit um die eidgenössische Schwurformel, in: Bewegung und Beharrung. Aspekte des reformierten Protestantismus, 1520-1650. FS für Emidio Campi, hg. v. Christian Moser und Peter Opitz unter Mitwirkung von Hans-Ulrich Bächtold, Luca Baschera und Alexandra Kess, Leiden/Boston 2009 - Studies in the History of Christian Traditions 144, S. 295-346.
Bächtold, Stäheli	"Eine fine hand zuͦ schreiben.” Glanz und Elend im Leben des Schönschreibers Israël		Hans Ulrich Bächtold, "Eine fine hand zuͦ schreiben.” Glanz und Elend im Leben des Schönschreibers Israël, 1596, in: Von Cyprian zur Walzenprägung. Streiflichter auf Zürcher Geist und Kultur der Bullingerzeit. Prof. Dr. Rudolf Schnyder zum 70. Geburtstag, hg. v. Hans Ulrich Bächtold, Zug 2001. - Studien und Texte zur Bullingerzeit 2, S. 115-143.
Bähler, Caroli	Petrus Caroli und Johannes Calvin. Ein Beitrag zur Geschichte und Kultur der Reformationszeit		Eduard Bähler, Petrus Caroli und Johannes Calvin. Ein Beitrag zur Geschichte und Kultur der Reformationszeit, in: JSG 29, 1904, S. 39-168.
Bähler, Dekan Haller	Dekan Johann Haller und die Berner Kirche 1548 bis 1575		Eduard Bähler, Dekan Johann Haller und die Berner Kirche 1548 bis 1575, in: Neues Berner Taschenbuch 28, 1922, S. 1-52 (abgekürzt Bähler, Dekan Haller I); 29, 1923, S. 1-65 (abgekürzt Bähler, Dekan Haller II); 30, 1924, S. 1-58 (abgekürzt Bähler, Dekan Haller III); 31, 1925, S. 1-61 (abgekürzt Bähler, Dekan Haller IV).
Bähler, Haller	Erlebnisse und Wirksamkeit des Predigers Johann Haller in Augsburg zur Zeit des schmalkaldischen Krieges		Eduard Bähler, Erlebnisse und Wirksamkeit des Predigers Johann Haller in Augsburg zur Zeit des schmalkaldischen Krieges, in: ZSKG 2, 1922, S. 1-69.
Bätscher, Kirchen- und Schulgeschichte	Kirchen- und Schulgeschichte der Stadt St. Gallen. Von Vadians Tod bis zur Gegenwart	I	Kirchen- und Schulgeschichte der Stadt St. Gallen. Von Vadians Tod bis zur Gegenwart, Bd. I.: 1550-1630, bearb. v. Theodor Wilhelm Bätscher, St. Gallen 1964.
Bèze, Corr.	Correspondance de Théodore de Bèze		Correspondance de Théodore de Bèze, zusammengetragen von Hippolyte Aubert, hg. v. Fernand Aubert, Henri Meylan, Alain Dufour u.a., 43 Bde, Genf 1960-2017.
Büchler, Appenzell (Büchler)	Die Politik des Landes Appenzell zwischen dem zweiten Kappeler Landfrieden und dem Goldenen Bund 1531-1586		Hans Büchler, Die Politik des Landes Appenzell zwischen dem zweiten Kappeler Landfrieden und dem Goldenen Bund 1531-1586, Diss. phil. Zürich, Bamberg 1969.
Büeler, Dasypodius (Büeler)	Ein Frauenfelder Humanist des 16. Jahrhunderts		Gustav Büeler, Petrus Dasypodius (Peter Hasenfratz). Ein Frauenfelder Humanist des 16. Jahrhunderts, Frauenfeld 1920 - Beilage zum Programm der thurgauischen Kantonsschule, Schuljahr 1919/20.
Bühler, Tobel	Geschichte der Johanniterkomturei Tobel		Hans Bühler, Geschichte der Johanniterkomturei Tobel, in: Thurgauische Beiträge zur vaterländischen Geschichte 122, 1985 (1986), S. 5-312.
Büsser, Bullinger	Heinrich Bullinger (1504-1575). Leben, Werk und Wirkung		Fritz Büsser, Heinrich Bullinger (1504-1575). Leben, Werk und Wirkung, 2 Bde., Zürich 2004/2005.
Büsser, De prophetae officio	De prophetae officio. Eine Gedenkrede Bullingers auf Zwingli		Fritz Büsser, De prophetae officio. Eine Gedenkrede Bullingers auf Zwingli, in: Festgabe Leonard von Muralt, zum siebzigsten Geburtstag 17. Mai 1970 überreicht von Freunden und Schülern, Zürich 1970, S. 245-257.
Büsser, Zwinglibild	Das katholische Zwinglibild. Von der Reformation bis zur Gegenwart		Fritz Büsser, Das katholische Zwinglibild. Von der Reformation bis zur Gegenwart, Zürich 1968.
CC	Corpus Catholicorum. Werke katholischer Schriftsteller im Zeitalter der Glaubensspaltung		Corpus Catholicorum. Werke katholischer Schriftsteller im Zeitalter der Glaubensspaltung, Münster in Westfalen 1919ff.
CChr-Gr	Corpus Christianorum. Series Graeca		Corpus Christianorum. Series Graeca, Turnhout/Paris 1977ff.
CChr-L (CChr)	Corpus Christianorum. Series Latina		Corpus Christianorum. Series Latina, Turnhout/Paris 1953ff.
CMD-CH	Katalog der datierten Handschriften in der Schweiz in lateinischer Schrift vom Anfang des Mittelalters bis 1550		Katalog der datierten Handschriften in der Schweiz in lateinischer Schrift vom Anfang des Mittelalters bis 1550, begründet von Albert Bruckner, in Zusammenarbeit mit dem Comité International de Paléographie hg. v. Max Burckhardt, Pascal Ladner und Martin Steinmann, 3 Bde., Dietikon/Zürich 1977-1991.
CO-R, Epist.	Ioannis Calvini Epistolae		Ioannis Calvini Epistolae, hg. v. Cornelis Augustijn und Frans Pieter van Stam, Genf 2005 - Ioannis Calvini Opera omnia denuo recognita et adnotatione critica instructa notisque illustrata, Series VI: Epistolae 1.
CR	Corpus Reformatorum		Corpus Reformatorum, Berlin u.a. 1834ff.
CSA	Calvin-Studienausgabe		Calvin-Studienausgabe, hg. v. Eberhard Busch u.a., 10 Bde., Neukirchen/Vluyn 1994-2011.
CSEL	Corpus Scriptorum Ecclesiasticorum Latinorum		Corpus Scriptorum Ecclesiasticorum Latinorum, Wien 1866ff.
CSch	Corpus Schwenckfeldianorum		Corpus Schwenckfeldianorum, publ. under the auspices of The Schwenckfelder Church, Pennsylvania, and the Hartford Theological Seminary, Connecticut USA, Bde. 1-14, Leipzig 1907-1936; Bde. 15-19, Pennsburg, Pennsylvania 1959-1961.
CT	Concilium Tridentinum. Diariorum, actorum, epistularum, tractatuum nova collectio		Concilium Tridentinum. Diariorum, actorum, epistularum, tractatuum nova collectio, hg. v. der Societas Goerresiana, Freiburg i. Br. 1901ff.
Capito, Corr.	Correspondance de Wolfgang Capiton (1478-1541). Analyse et index. (D'après le Thesaurus Baumianus et autres sources) par Olivier Millet		Correspondance de Wolfgang Capiton (1478-1541). Analyse et index. (D'après le Thesaurus Baumianus et autres sources) par Olivier Millet, Straßburg 1982 - Publications de la Bibliothèque Nationale et Universitaire de Strasbourg 8.
Cardauns	Von Nizza bis Crépy. Europäische Politik in den Jahren 1534 bis 1544		Ludwig Cardauns, Von Nizza bis Crépy. Europäische Politik in den Jahren 1534 bis 1544, Rom 1923 - Bibliothek des Preussischen Historischen Instituts in Rom 15.
Catalogus translationum	Catalogus translationum et commentariorum: Mediaeval and Renaissance Latin Translations and Commentaries		Catalogus translationum et commentariorum: Mediaeval and Renaissance Latin Translations and Commentaries, Annotated Lists and Guides, hg. v. Paul Oskar Kristeller u.a., Washington D.C. 1960ff.
Christoffel	Heinrich Bullinger und seine Gattin nach ihrem segenreichen Wirken in ihrer Familie, Gemeinde und gegen verfolgte Glaubensgenosssen		Raget Christoffel, Heinrich Bullinger und seine Gattin nach ihrem segenreichen Wirken in ihrer Familie, Gemeinde und gegen verfolgte Glaubensgenosssen, Zürich 1875.
Christoph von Württ. BW (Christoph von Württemberg BW)	Briefwechsel des Herzogs Christoph von Wirtemberg		Briefwechsel des Herzogs Christoph von Wirtemberg, hg. v. Viktor Ernst, 4 Bde., Stuttgart 1899-1904.
Clavadetscher	Beiträge zur Geschichte der Zisterzienserabtei Kappel am Albis		Otto Paul Clavadetscher, Beiträge zur Geschichte der Zisterzienserabtei Kappel am Albis. Diss. phil., Zürich 1875.
Cloulas, Henri II	Henri II		Ivan Cloulas, Henri II, Paris 1985.
Contemporaries	Contemporaries of Erasmus. A Biographical Register of the Renaissance and Reformation		Contemporaries of Erasmus. A Biographical Register of the Renaissance and Reformation, hg. v. Peter G. Bietenholz und Thomas B. Deutscher, 3 Bde., Toronto 1985-1987.
CorpICan (CorpIC)	Corpus Iuris Canonici		Corpus Iuris Canonici, hg. v. Emil Friedberg, 2 Teile, Leipzig 1879 (Nachdruck: Graz 1959).
Creutznachers Diarium	Ewald Creutznachers Diarium über den Reichstag zu Augsburg 1547-1548	45	Ewald Creutznachers Diarium über den Reichstag zu Augsburg 1547-1548, hg. v. Paul Glück, in: Archiv des Historischen Vereins von Unterfranken und Aschaffenburg, Bd. 45, Würzburg 1903, S. 297-329.
Crousaz, L'Académie	L'Académie de Lausanne entre Humanisme et Réforme		Karine Crousaz, L'Académie de Lausanne entre Humanisme et Réforme (ca. 1537-1560), Leiden/Boston 2012 - Education and Society in the Middle Ages and Renaissance 41.
Culmann, Schuler	Skizzen aus Gervasius Schuler's Leben und Wirken in Zürich		[Friedrich Wilhelm Culmann,] Skizzen aus Gervasius Schuler's Leben und Wirken in Zürich, Bischweiler, Bremgarten, Basel, Memmingen und Lenzburg, von 1520-1563, Straßburg 1855.
DBE	Deutsche Biographische Enzyklopädie		Deutsche Biographische Enzyklopädie, hg. v. Walther Killy, 10 Bde., München 1995-1999; Bde. 11/1 und 11/2: Nachträge und Register, München 2000.
DBI	Dizionario biografico degli italiani		Dizionario biografico degli italiani, Rom 1960ff.
DHEE	Diccionario de Historia Ecclesiástica de España		Diccionario de Historia Ecclesiástica de España, hg. v. Quintín Aldea Vaquero u.a., 4 Bde., Madrid 1972-1975.
DNB	Dictionary of National Biography from the Earliest Times to 1900		Dictionary of National Biography from the Earliest Times to 1900, 63 Bde., London 1885-1900.
DNP	Der Neue Pauly. Enzyklopädie der Antike		Der Neue Pauly. Enzyklopädie der Antike, hg. v. Hubert Cancik und Helmuth Schneider, Stuttgart/Weimar 1996ff.
DRW	Deutsches Rechtswörterbuch. Wörterbuch der älteren deutschen Rechtssprache		Deutsches Rechtswörterbuch. Wörterbuch der älteren deutschen Rechtssprache, hg. v. der Königlich-Preussischen Akademie der Wissenschaften, später v. der Heidelberger Akademie der Wissenschaften, Weimar/Heidelberg 1914ff.
DTC (DThC)	Dictionnaire de théologie catholique		Dictionnaire de théologie catholique, hg. v. Jean Michel, Alfred Vacant u.a., 15 Bde., Paris 1899-1950.
Das Collegium Alumnorum in Basel	Aus fünf jahrhunderten schweizerischer Kirchengeschichte		Das Kollegium Alumnorum in Basel, in: Aus fünf Jahrhunderten schweizerischer Kirchengeschichte. Zum sechzigsten Geburtstag von Paul Wernle. Helbing und Lichtenhahn, Basel 1910, S. 95–162.
Dasypodius, Dict.	Dictionarium latinogermanicum		Petrus Dasypodius, Dictionarium latinogermanicum, Straßburg 1536 (Nachdruck: Hildesheim/New York 1995).
Deetjen, Württ. (Deetjen)	Studien zur Württembergischen Kirchenordnung Herzog Ulrichs 1534-1550. Das Herzogtum Württemberg im Zeitalter Herzog Ulrichs (1498-1550), die Neuordnung des Kirchengutes und der Klöster (1534-1547)		Werner-Ulrich Deetjen, Studien zur Württembergischen Kirchenordnung Herzog Ulrichs 1534-1550. Das Herzogtum Württemberg im Zeitalter Herzog Ulrichs (1498-1550), die Neuordnung des Kirchengutes und der Klöster (1534-1547), Stuttgart 1981 - Quellen und Forschungen zur Württembergischen Kirchengeschichte 7.
Demandt, Schmalk. (Demandt)	Die Auseinandersetzungen des Schmalkaldischen Bundes mit Herzog Heinrich d.J. von Braunschweig-Wolfenbüttel im Briefwechsel des St. Galler Reformators Vadian		Dieter Demandt, Die Auseinandersetzungen des Schmalkaldischen Bundes mit Herzog Heinrich d.J. von Braunschweig-Wolfenbüttel im Briefwechsel des St. Galler Reformators Vadian, in: Zwa 22, 1995, 45-66.
Denis, Pays rhénans (Denis)	Les Eglises d'étrangers en Pays rhénans (1538-1564)		Philippe Denis, Les Eglises d'étrangers en Pays rhénans (1538-1564), Paris 1984 - Bibliothèque de la Faculté de Philosophie et Lettres de l'Université de Liège 242.
Denzinger (Denz.)	Kompendium der Glaubensbekenntnisse und kirchlichen Lehrentscheidungen. Enchiridion symbolorum, definitionum et declarationum de rebus fidei et morum.		Heinrich Denzinger, Kompendium der Glaubensbekenntnisse und kirchlichen Lehrentscheidungen. Enchiridion symbolorum, definitionum et declarationum de rebus fidei et morum. Verbessert, erweitert, ins Deutsche übertragen und hg. v. Peter Hünermann, 44. Aufl., Freiburg i. Br. 2014.
Deppermann	Soziale Unruhen und apokalyptische Visionen im Zeitalter der Reformation		Klaus Deppermann, Melchior Hoffman. Soziale Unruhen und apokalyptische Visionen im Zeitalter der Reformation, Göttingen 1979.
Detmers, Judentum	Reformation und Judentum. Israel-Lehren und Einstellungen zum Judentum von Luther bis zum frühen Calvin		Achim Detmers, Reformation und Judentum. Israel-Lehren und Einstellungen zum Judentum von Luther bis zum frühen Calvin, Köln 2001 - Judentum und Christentum 7.
Dingel, Augsb. Interim	Reaktionen auf das Augsburger Interim. Der Interimistische Streit (1548-1549)		Reaktionen auf das Augsburger Interim. Der Interimistische Streit (1548-1549), hg. v. Irene Dingel, bearb. v. Johannes Hund, Jan Martin Lies und Hans-Otto Schneider, Göttingen 2010 - Controversia et confessio 1.
Dobras, Ratsregiment	Ratsregiment, Sittenpolizei und Kirchenzucht in der Reichsstadt Konstanz 1531-1548. Ein Beitrag zur Geschichte der oberdeutsch-schweizerischen Reformation		Wolfgang Dobras, Ratsregiment, Sittenpolizei und Kirchenzucht in der Reichsstadt Konstanz 1531-1548. Ein Beitrag zur Geschichte der oberdeutsch-schweizerischen Reformation, Gütersloh 1993 - QFRG 59.
Dommasch	Die Religionsprozesse der rekusierenden Fürsten und Städte und die Erneuerung des schmalkaldischen Bundes 1534-1536		Gerd Dommasch, Die Religionsprozesse der rekusierenden Fürsten und Städte und die Erneuerung des schmalkaldischen Bundes 1534-1536, Tübingen 1961 - SKRG 28.
Druffel, BA	Briefe und Akten zur Geschichte des Sechzehnten Jahrhunderts mit besonderer Rücksicht auf Bayerns Fürstenhaus	1	Briefe und Akten zur Geschichte des Sechzehnten Jahrhunderts mit besonderer Rücksicht auf Bayerns Fürstenhaus, hg. v. August von Druffel, Bd. I: Beiträge zur Reichsgeschichte, 1546-1551, München 1873; Bd. III: Beiträge zur Reichsgeschichte, 1546-1552, München 1882.
Druffel, Karl V. (Druffel)	Kaiser Karl V. und die Römische Curie 1544-1546		August von Druffel, Kaiser Karl V. und die Römische Curie 1544-1546, Bd. I: Vom Speirer Reichstag bis zur Berufung des Trienter Concils; Bd. II: Von der Berufung des Trienter Concils bis zum Wormser Reichstagsabschied; Bd. III: Vom Wormser Reichstagsabschied bis zur Eröffnung des Trienter Concils; Bd. IV: Von der Eröffnung des Trienter Concils bis zur Begegnung des Kaisers mit dem Hessischen Landgrafen in Speier - Abhandlungen der Historischen Classe der Königlich Bayerischen Akademie der Wissenschaften 13/2, 16/1, 16/3, 19/2, München 1877, 1881, 1883, 1890.
Drüll, Gelehrtenlexikon	Heidelberger Gelehrtenlexikon 1386-1651		Dagmar Drüll, Heidelberger Gelehrtenlexikon 1386-1651, Berlin/Heidelberg 2002.
Du Bellay, Corr.	Correspondance du Cardinal Jean Du Bellay		Correspondance du Cardinal Jean Du Bellay, hg. v. Rémy Scheurer, Loris Petris u.a., Paris 1969ff.
Du Bellay, Mémoires	Mémoires de Martin et Guillaume du Bellay		Mémoires de Martin et Guillaume du Bellay, hg. v. Victor-Louis Bourrilly und Fleury Vindry, 4 Bde., Paris 1908-1919.
Du Cange	Charles du Fresne Du Cange, Glossarium mediae et infimae latinitatis cum supplementis integris D.P. Carpenterii et G.A.L. Henschel. Editio nova aucta pluribus verbis aliorum scriptorum a Léopold Favre		Charles du Fresne Du Cange, Glossarium mediae et infimae latinitatis cum supplementis integris D.P. Carpenterii et G.A.L. Henschel. Editio nova aucta pluribus verbis aliorum scriptorum a Léopold Favre, 4 Bde., Niort 1883-1887 (Nachdruck: Graz 1954).
Dütsch, Landvögte	Die Zürcher Landvögte von 1402-1798. Ein Versuch zur Bestimmung ihrer sozialen Herkunft und zur Würdigung ihres Amtes im Rahmen des zürcherischen Stadtstaates		Hans-Rudolf Dütsch, Die Zürcher Landvögte von 1402-1798. Ein Versuch zur Bestimmung ihrer sozialen Herkunft und zur Würdigung ihres Amtes im Rahmen des zürcherischen Stadtstaates, Diss. phil. Zürich, Zürich 1994.
EA	Amtliche Sammlung der ältern Eidgenössischen Abschiede		Amtliche Sammlung der ältern Eidgenössischen Abschiede, hg. v. Jakob Kaiser u.a., 8 Bde., Luzern 1839-1886 (Bd. IV/1d, bearb. v. Karl Deschwanden, Luzern 1882).
EDB	Zürcher Ehedaten des 16. bis 18. Jahrhunderts		Zürcher Ehedaten des 16. bis 18. Jahrhunderts, gehostet unter der Website des Staatsarchivs Zürich: http://www.staatsarchiv.zh.ch.
EDIT16	Le edizioni italiane del XVI secolo. Censimento nazionale		Le edizioni italiane del XVI secolo. Censimento nazionale, Rom 1985ff (http://edit16.iccu.sbn.it/).
EJ	Encyclopaedia Judaica		Encyclopaedia Judaica, 16 Bde., Jerusalem 1971/1972.
EKO	Die evangelischen Kirchenordnungen des XVI. Jahrhunderts		Die evangelischen Kirchenordnungen des XVI. Jahrhunderts, hg. v. Emil Sehling u.a., Leipzig/Tübingen, 1902ff.
Egelhaaf	Archivalische Beiträge zur Geschichte des schmalkaldischen Krieges		Gottlob Egelhaaf, Archivalische Beiträge zur Geschichte des schmalkaldischen Krieges, in: Programm des Karls-Gymnasiums in Stuttgart zum Schlusse des Schuljahrs 1895-96, Stuttgart 1896, S. 1-56.
Egli, Affoltern	Die Reformation im Bezirke Affoltern		Emil Egli, Die Reformation im Bezirke Affoltern, in: ZTB 1888, NF, Jg 11, S. 65-113.
Egli, Analecta	Analecta Reformatoria		Emil Egli, Analecta Reformatoria, 2 Bde., Zürich 1899/1901.
Egli, Komtur Schmid	Komtur Schmid von Küssnach		Emil Egli, Komtur Schmid von Küssnach, in: Zwa II 65-73.
Ein Brief Heinrich Bullingers	Zwingliana	9	Vischer, L. (2010) "Ein Brief Heinrich Bullingers", Zwingliana, 9(6), pp. 377–378.
Eisler	Wörterbuch der philosophischen Begriffe, historisch-quellenmäßig bearbeitet		Rudolf Eisler, Wörterbuch der philosophischen Begriffe, historisch-quellenmäßig bearbeitet, 3 Bde., Berlin 1927-1930.
Elton, Reform	Reform and Reformation. England 1509-1558 (The New History of England 2)		Geoffrey Rudolph Elton, Reform and Reformation. England 1509-1558, London 1977 - The New History of England 2.
Enders	Dr. Martin Luther's Briefwechsel		Dr. Martin Luther's Briefwechsel. Bearb. und mit Erläuterungen versehen v. Ernst Ludwig Enders. Fortgesetzt v. Gustav Kawerau u.a., 19 Bde., Frankfurt a. M./Stuttgart/Leipzig 1884-1932.
Enzinas BW	Francisco de Enzinas. Epistolario		Francisco de Enzinas. Epistolario, hg. mit einer spanischen Übersetzung v. Ignacio J. Garciá Pinilla, Genf 1995 - THR 290.
Epistolae Tigurinae	Original letters relative to the English Reformation, written during the reigns of King Henry VIII., King Edward VI. and Queen Mary: chiefly trom the archives of Zurich		Epistolae Tigurinae de rebus potissimum ad ecclesiae Anglicanae reformationem pertinentibus conscriptae A. D. 1531-1558. Ex schedis manuscriptis in bibliotheca Tigurina aliisque servatis Parkerianae societatis auspiciis editae, Cambridge 1848 (Nachdruck: New York 1968).
Epistolae Vireti	Epistolae Petri Vireti. The Unedited Letters and a Register of Pierre Viret's Correspondence		Epistolae Petri Vireti. The Unedited Letters and a Register of Pierre Viret's Correspondence, hg. v. Michael W. Bruening, Genf 2012 - THR 494.
Erhard, Reformation	Die Reformation der Kirche in Kempten auf Grund archivalischer Studien dargestellt		Otto Erhard, Die Reformation der Kirche in Kempten auf Grund archivalischer Studien dargestellt, Kempten (1917).
Erhard, Sakramentsstreitigkeiten	Die Sakramentsstreitigkeiten in Kempten 1530-1533		Otto Erhard, Die Sakramentsstreitigkeiten in Kempten 1530-1533, in: Beiträge zur bayerischen Kirchengeschichte, Bdd. XVII, Erlangen 1911, S. 153-173.
Erichson	Zwingli’s Tod und dessen Beurtheilung durch Zeitgenossen		Alfred Erichson, Zwingli’s Tod und dessen Beurtheilung durch Zeitgenossen. Zumeist nach ungedruckten Straßburger und Zürcher Urkunden, Straßburg 1883.
Euro-Climhist Datenbank	Informationssystem zur Witterungs- und Klimageschichte		Euro-Climhist. Informationssystem zur Witterungs- und Klimageschichte; Pfister, Christian, Rohr, Christian; Universität Bern; https://www.echdb.unibe.ch; DOI: 10.7892/boris.73059
FB	French Vernacular Books: Books Published in the French Language Before 1601. Livres vernaculaires français: Livres imprimés en français avant 1601		French Vernacular Books: Books Published in the French Language Before 1601. Livres vernaculaires français: Livres imprimés en français avant 1601: hg. v. Andrew Pettegree, Malcom Walsby, Alexander Wilkinson, 2Bde., Leiden/Boston 2007.
FNHDW (Anderson/Goebel/Reichmann)	Frühneuhochdeutsches Wörterbuch		Frühneuhochdeutsches Wörterbuch, hg. v. Ulrich Goebel und Oskar Reichmann, begründet von Robert R. Anderson, Ulrich Goebel und Oskar Reichmann, Berlin/New York 1989ff.
Fabian, Abschiede	Die Schmalkaldischen Bundesabschiede 1533-1536		Die Schmalkaldischen Bundesabschiede 1533-1536. Mit Ausschreiben der Bundestage und anderen archivalischen Beilagen, bearb. u. hg. v. Ekkehart Fabian, Tübingen 1958 - SKRG 8.
Fabian, Quellen (Reformationsbündnisse)	Quellen zur Geschichte der Reformationsbündnisse und der Konstanzer Reformationsprozesse 1529-1548		Quellen zur Geschichte der Reformationsbündnisse und der Konstanzer Reformationsprozesse 1529-1548, hg. v. Ekkehart Fabian, Tübingen/Basel 1967 - SKRG 34.
Fabian, Räte (Fabian, Geheime Räte)	Geheime Räte in Zürich, Bern, Basel und Schaffhausen		Ekkehart Fabian, Geheime Räte in Zürich, Bern, Basel und Schaffhausen. Quellen und Untersuchungen, Köln/Wien 1974 - SKRG 33.
Fabian, Städtetage	Die Beschlüsse der oberdeutschen Schmalkaldischen Städtetage		Die Beschlüsse der oberdeutschen Schmalkaldischen Städtetage, bearb. und hg. v. Ekkehart Fabian, 3 Teile, Tübingen 1959-1960 - SKRG 9f. 14f. 21-24.
Farel, Biographie	Guillaume Farel 1489-1565. Biographie nouvelle, écrite d'après les documents originaux par un groupe d'historiens, professeurs et pasteurs de Suisse, de France et d'Italie		Guillaume Farel 1489-1565. Biographie nouvelle, écrite d'après les documents originaux par un groupe d'historiens, professeurs et pasteurs de Suisse, de France et d'Italie, Neuchâtel/Paris 1930.
Farge, Paris Doctors	Bibliographical Register of Paris Doctors in Theology		James K. Farge, Bibliographical Register of Paris Doctors in Theology, 1500-1536, Toronto 1980. - Subsidia Mediaevalia 10.
Farner	Huldrych Zwingli		Oscar Farner, Huldrych Zwingli, 4 Bde., Zürich (1943-1960).
Fast	Heinrich Bullinger und die Täufer. Ein Beitrag zur Historiographie und Theologie im 16. Jahrhundert		Heinold Fast, Heinrich Bullinger und die Täufer. Ein Beitrag zur Historiographie und Theologie im 16. Jahrhundert, Weierhof (Pfalz) 1959. - Schriftenreihe des Mennonitischen Geschichtsvereins, Nr. 7.
Felix Platter, Pest	Beschreibung der Stadt Basel 1610 und Pestbericht 1610/11		Felix Platter, Beschreibung der Stadt Basel 1610 und Pestbericht 1610/11, hg. v. Valentin Lötscher, Basel/Stuttgart 1987 - Basler Chroniken 11.
Felix Platter, Tagebuch	Tagebuch (Lebensbeschreibung) 1536-1567		Felix Platter, Tagebuch (Lebensbeschreibung) 1536-1567, hg. v. Valentin Lötscher, Basel/Stuttgart 1976 - Basler Chroniken 10.
Feller	Die Geschichte Berns, Bd. II, Von der Reformation bis zum Bauernkrieg		Richard Feller, Die Geschichte Berns, Bd. II, Von der Reformation bis zum Bauernkrieg, 1516-1663, Bern 1954. - AHVB XLII, H. 2.
Feller-Bonjour	Geschichtsschreibung der Schweiz vom Spätmittelalter zur Neuzeit		Richard Feller und Edgar Bonjour, Geschichtsschreibung der Schweiz vom Spätmittelalter zur Neuzeit, 2 Bde., Basel-Stuttgart (1962).
Feyler	Die Beziehungen des Hauses Württemberg zur schweizerischen Eidgenossenschaft in der ersten Hälfte des XVI. Jahrhunderts		Anna Feyler, Die Beziehungen des Hauses Württemberg zur schweizerischen Eidgenossenschaft in der ersten Hälfte des XVI. Jahrhunderts, Diss. Zürich 1905.
Fischer	Conrrad Gessner 1515-1565		Hans Fischer, Conrrad Gessner 1515-1565, Zürich 1966. -Njbl. auf das Jahr 1966 als 168. Stück von der Naturforschenden in Gesellschaft Zürich hg.
Fischer	Schwäbisches Wörterbuch aufgrund der von Adelbert v. Keller begonnenen Sammlungen und mit Unterstützung des Württembergischen Staates		Schwäbisches Wörterbuch aufgrund der von Adelbert v. Keller begonnenen Sammlungen und mit Unterstützung des Württembergischen Staates bearb. von Hermann Fischer, 6 Bde., Tübingen 1904-1936.
Fischer, Chronik	Sebastian Fischers Chronik		Sebastian Fischers Chronik, hg. v. Karl Gustav Veesenmeyer, Ulm 1896 - Mitteilungen des Vereins für Kunst und Alterthum in Ulm und Oberschwaben 5-8.
Fp1 (Fp	La France protestante ou vies des protestants français		La France protestante ou vies des protestants français, hg. v. Eugène et Emile Haag, 10 Bde., Paris 1846-1858 (Nachdruck: Genf 1966).
Fp2 (Fp	La France protestante ou vies des protestants français		La France protestante ou vies des protestants français, 2. völlig neu bearbeitete Aufl., hg. v. Henri Bordier, 6 Bde. (unvollendet; von A bis Gasparin), Paris 1877-1888 (Nachdruck: Genf 2004).
Francesco Lismanino	Zeitschrift der Historischen Gesellschaft für die Provinz Posen		Wotschke, Theodor (1903) "Francesco Lismanino", Aus "Zeitschrift der Historischen Gesellschaft für die Provinz Posen zugleich Zeitschrift der Historischen Gesellschaft für den Netzedistrikt zu Bromberg", 18. Jahrgang, Posen 1903, S. 213-332.
Frey	Das Rheintal zur Zeit der Glaubensspaltung		Theodor Frey, Das Rheintal zur Zeit der Glaubensspaltung, Diss. phil. Freiburg i. Ue. 1946.
Friedrich, Kirchmair	Thomas Kirchmair, genannt Naogeorgus. Lebensbild eines bedeutenden Straubingers mit einem Literaturverzeichnis zu Biographie und Werk	89	Werner Friedrich, Thomas Kirchmair, genannt Naogeorgus. Lebensbild eines bedeutenden Straubingers mit einem Literaturverzeichnis zu Biographie und Werk, in: Jahresbericht des Historischen Vereins für Straubing und Umgebung, Bd. 89, 1987, S. 83-140.
Fuchtel	Der Frankfurter Anstand vom Jahre 1539		Paul Fuchtel, Der Frankfurter Anstand vom Jahre 1539, in: ARG XXVIII, 1931, S. 145-206.
Füssli (Füssli I)	Epistolae ab Ecclesiae Helveticae Reformatoribus vel ad eos scriptae. Centuria prima		Epistolae ab Ecclesiae Helveticae Reformatoribus vel ad eos scriptae. Centuria prima, hg. v. Johann Konrad Fuessli, Zürich 1742.
GCS	Die griechischen christlichen Schriftsteller der ersten Jahrhunderte		Die griechischen christlichen Schriftsteller der ersten Jahrhunderte, hg. v. der Berlin-Brandenburgischen Akademie der Wissenschaften, Leipzig u.a. 1897ff.
GG			Frank Hieronymus,
GLN	Bibliographie der im 15. und 16. Jahrhundert in Genf, Lausanne und Neuchâtel entstandenen Drucke		Bibliographie der im 15. und 16. Jahrhundert in Genf, Lausanne und Neuchâtel entstandenen Drucke (http://www.ville-ge.ch/musinfo/bd/bge/gln/).
GW	Gesamtkatalog der Wiegendrucke		Gesamtkatalog der Wiegendrucke, Leipzig u.a. 1925ff.
Gagliardi/Forrer (Gagliardi)	Katalog der Handschriften der Zentralbibliothek Zürich	2	Ernst Gagliardi und Ludwig Forrer, Katalog der Handschriften der Zentralbibliothek Zürich, Bd. 2: Neuere Handschriften seit 1500, Zürich 1982.
Gamper, Vadian	Joachim Vadian, 1483/84-1551. Humanist, Arzt, Reformator, Politiker, mit Beiträgen von Rezia Krauer und Clemens Müller		Rudolf Gamper, Joachim Vadian, 1483/84-1551. Humanist, Arzt, Reformator, Politiker, mit Beiträgen von Rezia Krauer und Clemens Müller, Zürich 2017.
Garrett, Exiles (Garrett, Marian Exiles)	The Marian Exiles. A Study in the Origins of Elizabethan Puritanism		Christina Hallowell Garrett, The Marian Exiles. A Study in the Origins of Elizabethan Puritanism, Cambridge 1938 (Nachdruck: Cambridge 1966).
Gast, Tagebuch	Das Tagebuch des Johannes Gast		Das Tagebuch des Johannes Gast, bearb. und hg. v. Paul Burckhardt, Basel 1945.
Gautier	Histoire de Genève des origines à l'année 1691		Jean-Antoine Gautier, Histoire de Genève des origines à l'année 1691, 9 Bde., Genf 1896-1914.
Gauß, Grynäus	Die Berufung des Simon Grynäus nach Tübingen		Karl Gauß, Die Berufung des Simon Grynäus nach Tübingen. 1534/35. Ein Nachklang zum Universitätsjubiläum, in: Basler Jahrbuch 1911, S. 88-130.
Gehrt, Konfessionspolitik	Ernestinische Konfessionspolitik. Bekenntnisbildung, Herrschaftskonsolidierung und dynastische Identitätsstiftung vom Augsburger Interim 1548 bis zur Konkordienformel 1577	34	Daniel Gehrt, Ernestinische Konfessionspolitik. Bekenntnisbildung, Herrschaftskonsolidierung und dynastische Identitätsstiftung vom Augsburger Interim 1548 bis zur Konkordienformel 1577, Leipzig 2011 - Arbeiten zur Kirchen- und Theologiegeschichte, Bd. 34.
Geiser, Haltung	Über die Haltung der Schweiz während des Schmalkaldischen Krieges		Karl Geiser, Über die Haltung der Schweiz während des Schmalkaldischen Krieges, Zürich 1897 (auch veröffentlicht in: JSG 22, 1897, S. 165-249).
Georges	Ausführliches lateinisch-deutsches Handwörterbuch		Ausführliches lateinisch-deutsches Handwörterbuch, ausgearbeitet von Karl Ernst Georges, 2 Bde., 14. Aufl., Hannover 1976.
Gerber, Kriegsrechnungen	Die Kriegsrechnungen des Schmalkaldischen Bundes über den Krieg im Oberland des Jahres 1546		Harry Gerber, Die Kriegsrechnungen des Schmalkaldischen Bundes über den Krieg im Oberland des Jahres 1546, in: ARG 32, 1935, 41-93. 218-247 (Abk.: Gerber, Kriegsrechnungen I); 33, 1936, 226-235 (Abk.: Gerber, Kriegsrechnungen II); 34, 1937, 87-122. 272-288 (Abk.: Gerber, Kriegsrechnungen III).
Gerwig Blarer BA	Gerwig Blarer, Abt von Weingarten, 1520-1567. Briefe und Akten		Gerwig Blarer, Abt von Weingarten, 1520-1567. Briefe und Akten, hg. v. Heinrich Günter, 2 Bde., Stuttgart 1914/1921 - Württembergische Geschichtsquellen 16f.
Gfr	Der Geschichtsfreund, Mitteilungen des historischen Vereins der fünf Orte Luzern, Uri, Schwyz, Unterwalden und Zug, Einsiedeln, 1843-1893		Der Geschichtsfreund, Mitteilungen des historischen Vereins der fünf Orte Luzern, Uri, Schwyz, Unterwalden und Zug, Einsiedeln, 1843-1893, Stans 1894ff.
Gilliard, Conquête	La Conquête du Pays de Vaud par les Bernois		Charles Gilliard, La Conquête du Pays de Vaud par les Bernois, Lausanne 1935. - Université de Lausanne. Publications de la Faculté des Lettres [II].
Gilliard, Les combats	Les combats de Gingins et de la Faucille en octobre et décembre 1535		Charles Gilliard, Les combats de Gingins et de la Faucille en octobre et décembre 1535, in: Bulletin de la Société d’histoire et d’archéologie de Genève VII, 1939, S. 3-27.
Gilly, Spanien	Spanien und der Basler Buchdruck bis 1600		Carlos Gilly, Spanien und der Basler Buchdruck bis 1600, Basel/Frankfurt a.M. 1985 - Basler Beiträge zur Geschichtswissenschaft 151.
Girolamo Zancho, reformierter Prediger in Chiavenna	Bündnerisches Monatsblatt		Girolamo Zancho, reformierter Prediger in Chiavenna, in: Bündnerisches Monatsblatt, Chur 10/1951, S. 289-301.
Glückshafenrodel	Der Glückshafenrodel des Freischiessens zu Zürich 1504. Mit Anhang und Beilagen		Der Glückshafenrodel des Freischiessens zu Zürich 1504. Mit Anhang und Beilagen, bearb. und hg. v. Friedrich Hegi, unter Mithilfe von Emil Usteri und Sinaida Zuber, 2 Bde., Zürich 1942.
Gordon, Discipline	Clerical Discipline and the Rural Reformation. The Synod in Zürich, 1532-1580		Bruce Gordon, Clerical Discipline and the Rural Reformation. The Synod in Zürich, 1532-1580, Bern 1992 - ZBRG 16.
Graubünden, Korr.	Bullingers Korrespondenz mit den Graubündnern		Bullingers Korrespondenz mit den Graubündnern, hg. v. Traugott Schieß, 3 Teile, Basel 1904-1906 - Quellen zur Schweizer Geschichte XXIII-XXV (Nachdruck: Nieuwkoop 1968).
Grimm	Deutsches Wörterbuch		Deutsches Wörterbuch von Jacob Grimm und Wilhelm Grimm, 16 Bde., Leipzig 1854-1954; Neubearbeitung, Leipzig u.a. 1983ff.
Grimm, Buchführer	Die Buchführer des deutschen Kulturbereichs und ihre Niederlassungsorte in der Zeitspanne 1490 bis um 1550		Heinrich Grimm, Die Buchführer des deutschen Kulturbereichs und ihre Niederlassungsorte in der Zeitspanne 1490 bis um 1550, in: Archiv für Geschichte des Buchwesens 7, 1966, Sp. 1153-1772.
Gritschke, Schwenck. (Gritschke, Schwenckfeldertum)	,Via Media': Spiritualistische Lebenswelten und Konfessionalisierung. Das süddeutsche Schwenckfeldertum im 16. und 17. Jahrhundert		Caroline Gritschke, ,Via Media': Spiritualistische Lebenswelten und Konfessionalisierung. Das süddeutsche Schwenckfeldertum im 16. und 17. Jahrhundert, Berlin 2006 - Colloquia Augustana 22.
Gropper BW	Johannes Gropper, Briefwechsel		Johannes Gropper, Briefwechsel, hg. von Reinhard Braunisch, 2 Bde., Münster 1977/2006 - Corpus Catholicorum 32 und 44.
Guggisberg	Sebastian Castellio 1515-1563. Humanist und Verteidiger der religiösen Toleranz im konfessionellen Zeitalter		Hans R. Guggisberg, Sebastian Castellio 1515-1563. Humanist und Verteidiger der religiösen Toleranz im konfessionellen Zeitalter, Göttingen 1997.
Guggisberg, Basel	Hans R. Guggisberg, Reformierter Stadtstaat und Zentrum der Spätrenaissance: Basel in der zweiten Hälfte des 16. Jahrhunderts		Hans R. Guggisberg, Reformierter Stadtstaat und Zentrum der Spätrenaissance: Basel in der zweiten Hälfte des 16. Jahrhunderts, in: Renaissance - Reformation. Gegensätze und Gemeinsamkeiten, Vorträge hg. v. August Buck, Wiesbaden 1984, S. 197-216 - Wolfenbütteler Abhandlungen zur Renaissanceforschung 5.
Guggisberg, Bern (Guggisberg)	Bernische Kirchengeschichte		Kurt Guggisberg, Bernische Kirchengeschichte, Bern 1958.
Gundlach, Behörden (Gundlach, Zentralbehörden)	Die hessischen Zentralbehörden von 1247-1604		Franz Gundlach, Die hessischen Zentralbehörden von 1247-1604, 3 Bde., Marburg 1930-1932 - Veröffentlichungen der Historischen Kommission für Hessen und Waldeck XVI/1-3.
Gundlach, Catalogus (Gundlach)	Catalogus Professorum Academiae Marburgensis. Die akademischen Lehrer der Philipps-Universität in Marburg von 1527-1910	1	Franz Gundlach, Catalogus Professorum Academiae Marburgensis. Die akademischen Lehrer der Philipps-Universität in Marburg von 1527-1910, Bd. 1, Marburg 1927 - Veröffentlichungen der Historischen Kommission für Hessen und Waldeck XV/1.
Götze	Frühneuhochdeutsches Glossar		Alfred Götze, Frühneuhochdeutsches Glossar, 7. Aufl., Berlin 1960 - Kleine Texte für Vorlesungen und Übungen 101.
HB-Fam.-Chron.	Bullingers Familiengeschichte		Bernhard Stettler, Bullingers Familiengeschichte. Edition und Kommentar, in: Zwa XLII, 2015, S. 1-82.
HBAC	Annales sive Chronicon Coenobii Capell		Peter Simler und Heinrich Bullinger, Annales sive Chronicon Coenobii Capell, in Simler II 397-455.
HBBW	Heinrich Bullinger, Briefwechsel		Heinrich Bullinger, Briefwechsel, bearb. v. Ulrich Gäbler, Endre Zsindely, Matthias Senn u.a., Zürich 1973ff - Heinrich Bullinger, Werke, 2. Abt.: Briefwechsel.
HBBW I	Heinrich Bullinger Werke (Briefwechsel)	1	Heinrich Bullinger Werke, Briefwechsel Band 1 (Briefe der Jahre 1524-1531), bearb. von Ulrich Gäbler und Endre Zsindely, Zürich 1974, 268 S., ISBN 3-290-11334-5.
HBBW I (Anhang 1)	Heinrich Bullinger Werke (Briefwechsel)	1	Heinrich Bullinger Werke, Briefwechsel Band 1 (Briefe der Jahre 1524-1531, Anhang 1), bearb. von Ulrich Gäbler und Endre Zsindely, Zürich 1974, 268 S., ISBN 3-290-11334-5.
HBBW I (Anhang 2)	Heinrich Bullinger Werke (Briefwechsel)	1	Heinrich Bullinger Werke, Briefwechsel Band 1 (Briefe der Jahre 1524-1531, Anhang 1), bearb. von Ulrich Gäbler und Endre Zsindely, Zürich 1974, 268 S., ISBN 3-290-11334-5.
HBBW II	Heinrich Bullinger Werke (Briefwechsel)	2	Heinrich Bullinger Werke, Briefwechsel Band 2 (Briefe des Jahres 1532), bearb. von Ulrich Gäbler, Endre Zsindely, Matthias Senn et al., Zürich 1982, 304 S., ISBN 3-290-11467-8.
HBBW III	Heinrich Bullinger Werke (Briefwechsel)	3	Heinrich Bullinger Werke, Briefwechsel Band 3 (Briefe des Jahres 1533), bearb. von Endre Zsindely und Matthias Senn, Zürich 1983, 292 S., ISBN 3-290-11531-3.
HBBW IV	Heinrich Bullinger Werke (Briefwechsel)	4	Heinrich Bullinger Werke, Briefwechsel Band 4 (Briefe des Jahres 1534), bearb. von Endre Zsindely, Matthias Senn, Kurt Jakob Rüetschi und Hans Ulrich Bächtold, Zürich 1989, 484 S., ISBN 3-290-11600-X.
HBBW IX	Heinrich Bullinger Werke (Briefwechsel)	9	Heinrich Bullinger Werke, Briefwechsel Band 9 (Briefe des Jahres 1539), bearb. von Hans Ulrich Bächtold und Rainer Henrich, Zürich 2002, 295 S., ISBN 3-290-17220-1.
HBBW V	Heinrich Bullinger Werke (Briefwechsel)	5	Heinrich Bullinger Werke, Briefwechsel Band 5 (Briefe des Jahres 1535), bearb. von Hans Ulrich Bächtold, Rainer Henrich und Kurt Jakob Rüetschi, Zürich 1992, 507 S., ISBN 3-290-10856-2.
HBBW VI	Heinrich Bullinger Werke (Briefwechsel)	6	Heinrich Bullinger Werke, Briefwechsel Band 6 (Briefe des Jahres 1536), bearb. von Hans Ulrich Bächtold und Rainer Henrich, Zürich 1995, 518 S., ISBN 3-290-10980-1.
HBBW VII	Heinrich Bullinger Werke (Briefwechsel)	7	Heinrich Bullinger Werke, Briefwechsel Band 7 (Briefe des Jahres 1537), bearb. von Hans Ulrich Bächtold und Rainer Henrich, Zürich 1998, 357 S., ISBN 3-290-10980-1.
HBBW VIII	Heinrich Bullinger Werke (Briefwechsel)	8	Heinrich Bullinger Werke, Briefwechsel Band 8 (Briefe des Jahres 1538), bearb. von Hans Ulrich Bächtold und Rainer Henrich, Zürich 2000, 311 S., ISBN 3-290-17211-2.
HBBW X	Heinrich Bullinger Werke (Briefwechsel)	10	Heinrich Bullinger Werke, Briefwechsel Band 10 (Briefe des Jahres 1540), bearb. von Hans Ulrich Bächtold und Rainer Henrich, Zürich 2003, 224 S., ISBN 3-290-17265-1.
HBBW X (Ergänzungsband)	Heinrich Bullinger Werke (Briefwechsel)	10	Heinrich Bullinger Werke, Briefwechsel Ergänzungsband A (Addenda und Gesamtregister zu Band 1-10), Bearb. von Hans Ulrich Bächtold und Rainer Henrich, Zürich 2004, 175 S., ISBN 3-290-17316-X.
HBBW XI	Heinrich Bullinger Werke (Briefwechsel)	11	Heinrich Bullinger Werke, Briefwechsel Band 11 (Briefe des Jahres 1541), bearb. von Rainer Henrich, Alexandra Kess und Chistian Moser, Zürich 2005, 385 S., ISBN 3-290-17339-9.
HBBW XII	Heinrich Bullinger Werke (Briefwechsel)	12	Heinrich Bullinger Werke, Briefwechsel Band 12 (Briefe des Jahres 1542), bearb. von Rainer Henrich, Alexandra Kess und Chistian Moser, Zürich 2006, 299 S., ISBN 978-3-290-17431-6.
HBBW XIII	Heinrich Bullinger Werke (Briefwechsel)	13	Heinrich Bullinger Werke, Briefwechsel Band 13 (Briefe des Jahres 1543), bearb. von Rainer Henrich, Alexandra Kess und Chistian Moser, Zürich 2008, 381 S., ISBN 978-3-290-17459-0.
HBBW XIV	Heinrich Bullinger Werke (Briefwechsel)	14	Heinrich Bullinger Werke, Briefwechsel Band 14 (Briefe des Jahres 1544), bearb. von Reinhard Bodenmann, Alexandra Kess und Judith Steiniger, Zürich 2011, 645 S., ISBN 978-3-290-17565-8.
HBBW XIX	Heinrich Bullinger Werke (Briefwechsel)	19	Heinrich Bullinger Werke, Briefwechsel Band 19 (Briefe von Januar bis März 1547), bearb. von Reinhard Bodenmann, Alexandra Kess und Judith Steiniger, Zürich 2019, 496 S., ISBN 978-3-290-18186-4.
HBBW XV	Heinrich Bullinger Werke (Briefwechsel)	15	Heinrich Bullinger Werke, Briefwechsel Band 15 (Briefe des Jahres 1545), bearb. von Reinhard Bodenmann, Alexandra Kess und Judith Steiniger, Zürich 2013, 746 S., ISBN 978-3-290-17664-8.
HBBW XVI	Heinrich Bullinger Werke (Briefwechsel)	16	Heinrich Bullinger Werke, Briefwechsel Band 16 (Briefe von Januar bis Mai 1546), bearb. von Reinhard Bodenmann, Alexandra Kess und Judith Steiniger, Zürich 2014, 443 S., ISBN 978-3-290-17760-7.
HBBW XVII	Heinrich Bullinger Werke (Briefwechsel)	17	Heinrich Bullinger Werke, Briefwechsel Band 17 (Briefe von Juni bis September 1546), bearb. von Reinhard Bodenmann, Alexandra Kess und Judith Steiniger, Zürich 2015, 547 S., ISBN 978-3-290-17782-9.
HBBW XVIII	Heinrich Bullinger Werke (Briefwechsel)	18	Heinrich Bullinger Werke, Briefwechsel Band 18 (Briefe von Oktober bis Dezember 1546), bearb. von Reinhard Bodenmann, Alexandra Kess und Judith Steiniger, Zürich 2017, 496 S., ISBN 978-3-290-17889-5.
HBBW XX	Heinrich Bullinger Werke (Briefwechsel)	20	Heinrich Bullinger Werke, Briefwechsel Band 20 (Briefe von April bis Dezember 1547), bearb. von Reinhard Bodenmann, Yvonne Häfner und Judith Steiniger, Zürich 2022, 808 S., ISBN 978-3-290-18354-7.
HBBW XX (Anhang)	Heinrich Bullinger Werke (Briefwechsel)	20	Heinrich Bullinger Werke, Briefwechsel Band 20 (Anhang), Bearb. von Reinhard Bodenmann, Yvonne Häfner und Judith Steiniger, Zürich 2022, 808 S., ISBN 978-3-290-18354-7.
HBBibl	Heinrich Bullinger, Bibliographie		Heinrich Bullinger, Bibliographie, Bd. 1: Beschreibendes Verzeichnis der gedruckten Werke von Heinrich Bullinger, bearb. v. Joachim Staedtke u.a., Zürich 1972; Bd. 2: Beschreibendes Verzeichnis der Literatur über Heinrich Bullinger, bearb. v. Erland Herkenrath, Zürich 1977; Bd. 3: Heinrich Bullingers Privatbibliothek, bearb v. Urs B. Leu und Sandra Weidmann, Zürich 2004 - Heinrich Bullinger, Werke, 1. Abt.: Bibliographie.
HBD	Heinrich Bullingers Diarium (Annales vitae) der Jahre 1504-1574		Heinrich Bullingers Diarium (Annales vitae) der Jahre 1504-1574. Zum 400. Geburtstag Bullingers am 18. Juli 1904 hg. v. Emil Egli, Basel 1904 (Nachdruck: Zürich 1985) - QSRG 2.
HBGesA	Heinrich Bullinger 1504-1575. Gesammelte Aufsätze zum 400. Todestag		Heinrich Bullinger 1504-1575. Gesammelte Aufsätze zum 400. Todestag, hg. v. Ulrich Gäbler und Erland Herkenrath, 2 Bde., Zürich 1975 - ZBRG 7f.
HBLS	Historisch-biographisches Lexikon der Schweiz		Historisch-biographisches Lexikon der Schweiz, 7 Bde., Neuenburg 1921-1934.
HBLife	Heinrich Bullinger. Life - Thought - Influence.		Heinrich Bullinger. Life - Thought - Influence. Zurich, Aug. 25-29, 2004. International Congress Heinrich Bullinger (1504-1575), hg. v. Emidio Campi und Peter Opitz, 2 Bde., Zürich 2007 - ZBRG 24.
HBRG	Heinrich Bullingers Reformationsgeschichte		Heinrich Bullingers Reformationsgeschichte, nach dem Autographon hg. v. Johann Jakob Hottinger und Hans Heinrich Vögeli, 3 Bde., Frauenfeld 1838-1840; Register, bearb. v. Willy Wuhrmann, Zürich 1913 (Nachdruck: Zürich 1985).
HBSR	Heinrich Bullinger, Studiorum ratio - Studienanleitung		Heinrich Bullinger, Studiorum ratio - Studienanleitung, hg. v. Peter Stotz, 2 Teilbde., Zürich 1987 - Heinrich Bullinger, Werke, Sonderbd.
HBSchr	Heinrich Bullinger, Schriften.		Heinrich Bullinger, Schriften. Im Auftrag des Zwinglivereins und in Zusammenarbeit mit Hans Ulrich Bächtold, Ruth Jörg, Peter Opitz hg. v. Emidio Campi, Detlef Roth und Peter Stotz, 7 Bde., Zürich 2004-2007.
HBSchrzT	Heinrich Bullinger. Schriften zum Tage		Heinrich Bullinger. Schriften zum Tage, hg. v. Hans Ulrich Bächtold, Ruth Jörg und Christian Moser, Zug 2007 - Studien und Texte zur Bullingerzeit 3.
HBTS	Heinrich Bullinger, Theologische Schriften		Heinrich Bullinger, Theologische Schriften, bearb. v. Hans-Georg vom Berg, Susanna Hausammann, Bernhard Schneider u.a., Zürich 1983ff - Heinrich Bullinger, Werke, 3. Abt.
HLS	Historisches Lexikon der Schweiz		Historisches Lexikon der Schweiz, Basel 2002ff.
HRG	Handwörterbuch zur deutschen Rechtsgeschichte		Handwörterbuch zur deutschen Rechtsgeschichte, hg. v. Adalbert Erler und Ekkehard Kaufmann, 5 Bde., Berlin 1971-1998.
HSG	Handbuch der Schweizer Geschichte	1	Handbuch der Schweizer Geschichte, Bd. I, Zürich 1972.
HZ	Historische Zeitschrift		Historische Zeitschrift, München, 1859ff.
HaBG (Handbuch der Bündner Geschichte)	Handbuch der Bündner Geschichte		Handbuch der Bündner Geschichte, hg. v. Verein für Bündner Kulturforschung im Auftrag der Regierung des Kantons Graubünden, Bd. 1: Frühzeit bis Mittelalter; Bd. 2: Frühe Neuzeit; Bd. 3: 19. und 20. Jahrhundert; Bd. 4: Quellen und Materialien, Chur 2000.
Haefliger, Solothurn (Haefliger)	Solothurn in der Reformation		Hans Haefliger, Solothurn in der Reformation, Diss. phil. Bern, Solothurn 1945 (auch in: Jb. für Solothurnische Geschichte 16, 1943, S. 1-120; 17, 1944, S. 1-92).
Hagenbach, Koran	Luther und der Koran vor dem Rathe zu Basel		Karl Rudolf Hagenbach, Luther und der Koran vor dem Rathe zu Basel, in: Beiträge zur verländischen Geschichte 9, 1870.
Hain	Repertorium Bibliographicum in quo libri omnes ab arte typographica inventa usque ad annum MD. typis expressi ordine alphabetico vel simpliciter enumerantur vel adcuratius recensentur		Ludwig Hain, Repertorium Bibliographicum in quo libri omnes ab arte typographica inventa usque ad annum MD. typis expressi ordine alphabetico vel simpliciter enumerantur vel adcuratius recensentur, 2 Bde., Stuttgart-Paris 1826/1838 (Nachdruck: Mailand 1948)
Halter	Geschichte des Dominikanerinnen-Klosters Oetenbach in Zürich 1234-1525		Annemarie Halter, Geschichte des Dominikanerinnen-Klosters Oetenbach in Zürich 1234-1525, Diss. Phil. Zürich, Winterthur 1956.
Hammer, Mel.	Die Melanchthonforschung im Wandel der Jahrhunderte. Ein beschreibendes Verzeichnis		Wilhelm Hammer, Die Melanchthonforschung im Wandel der Jahrhunderte. Ein beschreibendes Verzeichnis, 4 Bde., Gütersloh 1967-1996. - Quellen und Forschungen zur Reformationsgeschichte 35. 36. 49. 65.
Hammer-Purgstall	Geschichte des Osmanischen Reiches		Joseph von Hammer-Purgstall, Geschichte des Osmanischen Reiches, größtentheils aus bisher unbenützten Handschriften und Archiven, 10 Bde., Pest 1827-1835 (Nachdruck: Graz 1963).
Hanhart	Ein Beytrag zur Geschichte des wissenschaftlichen Strebens und der Glaubensverbesserung im 16. Jahrhundert		Johannes Hanhart, Conrad Geßner. Ein Beytrag zur Geschichte des wissenschaftlichen Strebens und der Glaubensverbesserung im 16. Jahrhundert, Winterthur 1824.
Hasenclever, Hessen	Die Politik Kaiser Karls V. und Landgraf Philipps von Hessen vor Ausbruch des schmalkaldischen Krieges		Adolf Hasenclever, Die Politik Kaiser Karls V. und Landgraf Philipps von Hessen vor Ausbruch des schmalkaldischen Krieges. Januar bis Juli 1546, Marburg 1903.
Hasenclever, Kurpfalz	Die kurpfälzische Politik in den Zeiten des schmalkaldischen Krieges (Januar 1546 bis Januar 1547)		Adolf Hasenclever, Die kurpfälzische Politik in den Zeiten des schmalkaldischen Krieges (Januar 1546 bis Januar 1547), Heidelberg 1905 - Heidelberger Abhandlungen zur mittleren und neueren Geschichte 10.
Hasenclever, Politik	Die Politik der Schmalkaldener vor Ausbruch des schmalkaldischen Krieges		Adolf Hasenclever, Die Politik der Schmalkaldener vor Ausbruch des schmalkaldischen Krieges, Berlin 1901 - Historische Studien 23.
Hausammann	Römerbriefauslegungen zwischen Humanismus und Reformation. Eine Studie zu Heinrich Bullingers Römerbriefvorlesung von 1525		Susi Hausammann, Römerbriefauslegungen zwischen Humanismus und Reformation. Eine Studie zu Heinrich Bullingers Römerbriefvorlesung von 1525, Zürich 1970. - StDTh XXVII.
Hauswirth	Landgraf Philipp von Hessen und Zwingli. Voraussetzungen und Geschichte der politischen Beziehungen zwischen Hessen, Straßburg, Konstanz, Ulrich von Württemberg und reformierten Eidgenossen 1526-1531		René Hauswirth, Landgraf Philipp von Hessen und Zwingli. Voraussetzungen und Geschichte der politischen Beziehungen zwischen Hessen, Straßburg, Konstanz, Ulrich von Württemberg und reformierten Eidgenossen 1526-1531, Tübingen und Basel 1968. - SKRG 35.
Heidrich, Erbfolgestreit	Der geldrische Erbfolgestreit 1537-1543		Paul Heidrich, Der geldrische Erbfolgestreit 1537-1543, Kassel 1896 - Beiträge zur deutschen Territorial- und Stadtgeschichte, Serie I, Heft 1.
Heidrich, Karl V.	Karl V. und die deutschen Protestanten am Vorabend des Schmalkaldischen Krieges		Paul Heidrich, Karl V. und die deutschen Protestanten am Vorabend des Schmalkaldischen Krieges, 2 Bde., Frankfurt 1911/1912 - Frankfurter Historische Forschungen 5 und 6.
Held	Die Tätigkeit des Ambrosius Blarer im Herzogtum Württemberg in den Jahren 1534-1538, dargestellt nach seinem Briefwechsel		Friedrich Held, Die Tätigkeit des Ambrosius Blarer im Herzogtum Württemberg in den Jahren 1534-1538, dargestellt nach seinem Briefwechsel, in: BWKG 65, 1965, S. 150-206.
Helvetia Sacra	Helvetia Sacra		Helvetia Sacra, begründet von Rudolf Henggeler, weitergeführt von Albert Bruckner, hg. v. Kuratorium der Helvetia Sacra, 10 Abt. in 28 Bde., Bern u.a. 1972-2007.
Henne	Histoire du règne de Charles-Quint en Belgique		Alexandre Henne, Histoire du règne de Charles-Quint en Belgique, 10 Bde., Brüssel/Leipzig 1858-1860.
Henrich, Myconius BW (Henrich, Myconius)	Oswald Myconius. Briefwechsel, 1515-1552.		Oswald Myconius. Briefwechsel, 1515-1552. Regesten, bearb. v. Rainer Henrich, Zürich 2017.
Henrich, Nachlass (Henrich, Bullingers Nachlass)	Heinrich Bullingers letztwillige Verfügung über seinen schriftlichen Nachlass		Rainer Henrich, Heinrich Bullingers letztwillige Verfügung über seinen schriftlichen Nachlass, in: Bewegung und Beharrung. Aspekte des reformierten Protestantismus, 1520-1650. FS für Emidio Campi, hg. v. Christian Moser und Peter Opitz unter Mitwirkung von Hans-Ulrich Bächtold, Luca Baschera und Alexandra Kess, Leiden/Boston 2009, S. 181-191 - Studies in the History of Christian Traditions 144.
Herberger, Schertlin	Sebastian Schertlin von Burtenbach und seine an die Stadt Augsburg geschriebenen Briefe		Theodor Herberger, Sebastian Schertlin von Burtenbach und seine an die Stadt Augsburg geschriebenen Briefe, Augsburg 1852.
Hergang (Hergang/Peschek)	Briefwechsel Zittauer Ratsherren mit Häuptern der reformirten Kirche zu Zürich im Zeitalter 1541		Karl Theodor Hergang und Christian Adolf Peschek, Briefwechsel Zittauer Ratsherren mit Häuptern der reformirten Kirche zu Zürich im Zeitalter 1541, in: Neues Lausitzisches Magazin 36, Görlitz 1860, S. 145-155.
Herminjard (Corr. des réformateurs)	Correspondance des réformateurs		Correspondance des réformateurs dans les pays de langue française, recueillie et publiée avec d'autres lettres relatives à la réforme et des notes historiques et biographiques par Aimé-Louis Herminjard, 9 Bde., Genf/Paris 1866-1897 (Nachdruck: Nieuw­koop 1965-1966).
Hess. Landtagsabschiede	Hessische Landtagsabschiede, 1526-1603		Hessische Landtagsabschiede, 1526-1603, hg. v. Günter Hollenberg, bearb. v. Günter Hollenberg und Heinrich Maulhardt, Marburg 1994 - Vorgeschichte und Geschichte des Parlamentarismus in Hessen 9; Veröffentlichung der Historischen Kommission für Hessen 48/5.
Heyd, Ulrich von Württ. (Heyd)	Ulrich, Herzog zu Württemberg. Ein Beitrag zur Geschichte Württembergs und des deutschen Reichs im Zeitalter der Reformation		Ludwig Friedrich Heyd, Ulrich, Herzog zu Württemberg. Ein Beitrag zur Geschichte Württembergs und des deutschen Reichs im Zeitalter der Reformation, 3 Bde., Tübingen 1841-1844.
Heß	Lebensgeschichte M. Heinrch Bullingers, Antistes der Kirche Zürichs		Salomon Heß, Lebensgeschichte M. Heinrch Bullingers, Antistes der Kirche Zürichs, 2 Bde., Zürich 1828/1829.
Hieronymus, Petri	1488 Petri		Frank Hieronymus, 1488 Petri - Schwabe 1988, Basel 1997.
Higman, Printing	Piety and the People. Religious Printing in French		Francis M. Higman, Piety and the People. Religious Printing in French, 1511-1551, Ipswich 1996 - St Andrews Studies in Reformation History.
Hildebrandt, Exiles	A Study of the English Protestant Exiles in Northern Switzerland and Strasbourg 1539-47 and their Role in the English Reformation		Esther Frances Mary Hildebrandt, A Study of the English Protestant Exiles in Northern Switzerland and Strasbourg 1539-47 and their Role in the English Reformation, Ph. D. Thesis, University of Durham, Department of Modern History, 1982 (Typoskript).
Hilgenfeld	Mittelalterlich-traditionelle Elemente in Luthers Abendmahlsschriften		Hartmut Hilgenfeld, Mittelalterlich-traditionelle Elemente in Luthers Abendmahlsschriften, Zürich 1971. - StDTh XXIX.
Horning, Briefe	Briefe von Straßburger Reformatoren, ihren Mitarbeitern und Freunden über die Einführung des "Interims" in Strassburg (1548-1554)		Briefe von Straßburger Reformatoren, ihren Mitarbeitern und Freunden über die Einführung des "Interims" in Strassburg (1548-1554), hg. v. Wilhelm Horning, Straßburg 1887.
Hottinger	Historia ecclesiastica Novi Testamenti		Johann Heinrich Hottinger, Historia ecclesiastica Novi Testamenti, 9 Bde., Zürich 1651-1667.
Hoven	Lexique de la prose latine de la Renaissance. Deuxième édition revue et considérablement augmentée		René Hoven, Lexique de la prose latine de la Renaissance. Deuxième édition revue et considérablement augmentée, Leiden/Boston 2006.
Hundeshagen	Die Conflikte des Zwinglianismus, Lutherthums und Calvinismus in der Bernischen Landeskirche von 1532-1558		Carl Bernhard Hundeshagen, Die Conflikte des Zwinglianismus, Lutherthums und Calvinismus in der Bernischen Landeskirche von 1532-1558, Bern 1842.
Hänny	Meister Gervasius Schuler. Reformator und Prädikant in Lenzburg von 1550-1563		Hans Hänny, Meister Gervasius Schuler. Reformator und Prädikant in Lenzburg von 1550-1563, in: Lenzburger Neujahrsblätter, Jg. 15, 1944, S. 14-51.
Ind. Aur.	Index Aureliensis. Catalogus librorum sedecimo saeculo impressorum. Pars prima	1	Index Aureliensis. Catalogus librorum sedecimo saeculo impressorum. Pars prima, Bd. 1ff, Baden-Baden 1965ff.
Index	Index des livres interdits		Index des livres interdits, hg. v. Jesús Martínez De Bujanda, 11 Bde., Genf, Sherbrooke und Montréal 1985-2011.
Inventaire	Inventaire chronologique des éditions parisiennes du XVI		Inventaire chronologique des éditions parisiennes du XVI
Iten	Tugium sacrum. Der Weltklerus zugerischer Herkunft und Wirksamkeit bis 1952	2	Albert Iten, Tugium sacrum. Der Weltklerus zugerischer Herkunft und Wirksamkeit bis 1952. Gedenkbuch zum 100jährigen Bestand der Sektion Zug “Zuger Verein für für Heimatgeschichte” des Historischen Verreins der V Orte, Stans (1952). - Gfr. 1952, Bd. 2.
Ißleib	Der Braunschweigische Krieg im Jahre 1545		Simon Ißleib, Der Braunschweigische Krieg im Jahre 1545, Dresden 1876.
JSG	Jahrbuch für Schweizerische Geschichte		Jahrbuch für Schweizerische Geschichte, hg. auf Veranstaltung der Allgemeinen Geschichtforschenden Gesellschaft der Schweiz, 45 Bde., Zürich 1876-1920.
Jacob, Führungsschicht (Jacob)	Politische Führungsschicht und Reformation. Untersuchungen zur Reformation in Zürich 1519-1528		Walter Jacob, Politische Führungsschicht und Reformation. Untersuchungen zur Reformation in Zürich 1519-1528, Zürich 1970 - ZBRG 1.
Jahns, Frankfurt (Jahns)	Frankfurt, Reformation und Schmalkaldischer Bund. Die Reformations-, Reichs- und Bündnispolitik der Reichsstadt Frankfurt am Main 1525-1536		Sigrid Jahns, Frankfurt, Reformation und Schmalkaldischer Bund. Die Reformations-, Reichs- und Bündnispolitik der Reichsstadt Frankfurt am Main 1525-1536, Frankfurt a. M. 1976 - Studien zur Frankfurter Geschichte 9.
Janse, Hardenberg	Albert Hardenberg als Theologe. Profil eines Bucer-Schülers		Wim Janse, Albert Hardenberg als Theologe. Profil eines Bucer-Schülers, Leiden 1994 - Studies in the History of Christian Thought 57.
Jaumann (Jaumann, Gelehrtenkultur I)	Handbuch Gelehrtenkultur der Frühen Neuzeit	1	Herbert Jaumann, Handbuch Gelehrtenkultur der Frühen Neuzeit. Bd. 1: Bio-bibliographisches Repertorium, Berlin/New York 2004.
Jedin, Trient	Geschichte des Konzils von Trient		Hubert Jedin, Geschichte des Konzils von Trient, 4 Bde., 2. Aufl., Freiburg 1951-1975.
Jenny, Humanismus	Humanismus und städtische Eliten in Basel im 16. Jahrhundert unter besonderer Berücksichtigung der Basler Lateinschulen von 1529-1586		Beat R. Jenny, Humanismus und städtische Eliten in Basel im 16. Jahrhundert unter besonderer Berücksichtigung der Basler Lateinschulen von 1529-1586, in: Platteriana. Beiträge zum 500. Geburtstag des Thomas Platter (1499?-1582), hg. v. Werner Meyer / Kaspar von Greyerz, Basel 2002 - Basler Beiträge zur Geschichtswissenschaft 175, S. 77-121.
Junod/Meylan	L'Académie de Lausanne au XVI. siècle. Leges scholae Lausannensis 1547. Lettres et documents inédits		Louis Junod und Henri Meylan, L'Académie de Lausanne au XVI. siècle. Leges scholae Lausannensis 1547. Lettres et documents inédits, Lausanne 1947 - Etudes et documents pour servir à l'histoire de l'Université de Lausanne 5.
Jöcher	Allgemeines Gelehrten-Lexicon		Allgemeines Gelehrten-Lexicon, hg. v. Christian Gottlieb Jöcher, 4 Bde., Leipzig 1750-1751 (Nachdruck: Hildesheim 1960-1961).
Jöcher, Fort.	Fortsetzung und Ergänzungen zu Christian Gottlieb Jöchers allgemeinem gelehrten Lexicon		Fortsetzung und Ergänzungen zu Christian Gottlieb Jöchers allgemeinem gelehrten Lexicon, bearb. v. Johann Christoph Adelung und Heinrich Wilhelm Rotermund, 7 Bde., Leipzig 1784-1897.
Jürgens, A Lasco (Jürgens, a Lasco)	Johannes a Lasco in Ostfriesland. Der Werdegang eines europäischen Reformators		Henning P. Jürgens, Johannes a Lasco in Ostfriesland. Der Werdegang eines europäischen Reformators, Tübingen 2002 - Spätmittelalter und Reformation. Neue Reihe 18.
KP	Der Kleine Pauly. Lexikon der Antike		Der Kleine Pauly. Lexikon der Antike, Bde. 1-3, Stuttgart 1964-1969; Bde. 4-5, München 1972/1975.
Kammerer	Schweizer Quellen zur württembergischen Reformationsgeschichte		Immanuel Kammerer, Schweizer Quellen zur württembergischen Reformationsgeschichte, in: BWKG 57/58, 1957/58, 14-25.
Kannengiesser	Karl V. und Maximilian Egmont, Graf von Büren. Ein Beitrag zur Geschichte des Schmalkaldischen Krieges		Paul Kannengiesser, Karl V. und Maximilian Egmont, Graf von Büren. Ein Beitrag zur Geschichte des Schmalkaldischen Krieges, Freiburg i. Br./ Leipzig 1895.
Karl V. BW (Karl V. Correspondenz)	Correspondenz des Kaisers Karl V. aus dem königlichen Archiv und der Bibliothèque de Bourgogne zu Brüssel		Correspondenz des Kaisers Karl V. aus dem königlichen Archiv und der Bibliothèque de Bourgogne zu Brüssel, hg. v. Karl Lanz, 3 Bde., Leipzig 1844-1846.
Karl V. SP	Staatspapiere zur Geschichte des Kaisers Karl V. aus dem königlichen Archiv und der Bibliothèque de Bourgogne zu Brüssel		Staatspapiere zur Geschichte des Kaisers Karl V. aus dem königlichen Archiv und der Bibliothèque de Bourgogne zu Brüssel, hg. v. Karl Lanz, Stuttgart 1845.
Keim, Ulm	Die Reformation der Reichsstadt Ulm. Ein Beitrag zur schwäbischen und deutschen Reformationsgeschichte		Carl Theodor Keim, Die Reformation der Reichsstadt Ulm. Ein Beitrag zur schwäbischen und deutschen Reformationsgeschichte, Stuttgart 1851.
Keller	Die Wiedereinsetzung des Herzogs Ulrich von Württemberg durch den Landgrafen Philipp von Hessen 1533/34		Alfred Keller, Die Wiedereinsetzung des Herzogs Ulrich von Württemberg durch den Landgrafen Philipp von Hessen 1533/34, Diss. Marburg 1912.
Keller, Jakob Ruf	Leben, Werk und Studien		Jakob Ruf. Leben, Werk und Studien, hg. v. Hildegard Elisabeth Keller, 5 Bde., Zürich 2008.
Kessler, Sabbata (Keßler, Sabbata)	Johannes Keßlers Sabbata mit kleineren Schriften und Briefen		Johannes Keßlers Sabbata mit kleineren Schriften und Briefen. Unter Mitwirkung von Emil Egli und Rudolf Schoch hg. v. Historischen Verein des Kantons St. Gallen, St. Gallen 1902.
Kilchenmann, Ehegericht	Die Organisation des zürcherischen Ehegerichts zur Zeit Zwinglis		Küngolt Kilchenmann, Die Organisation des zürcherischen Ehegerichts zur Zeit Zwinglis, Zürich 1946 - Quellen und Abhandlungen zur Geschichte des Schweizerischen Protestantismus 1.
Killy2 (Killy	Killy Literaturlexikon		Killy Literaturlexikon. Autoren und Werke des deutschsprachigen Kulturraumes, 2. vollständig überarbeitete Auflagen hg. v. Wilhelm Kühlmann, 13 Bde., Berlin 2008-2012.
Kindler von Knobloch	Oberbadisches Geschlechterbuch		Oberbadisches Geschlechterbuch, hg. v. der Badischen Historischen Kommission, bearb. v. Julius Kindler von Knobloch, 3 Bde., Heidelberg 1898-1919.
Kirch, Fugger	Die Fugger und der Schmalkaldische Krieg		Hermann Joseph Kirch, Die Fugger und der Schmalkaldische Krieg, München/Leipzig 1915 - Studien zur Fugger-Geschichte 5.
Kirchenordnung-ZH	Zürcher Kirchenordnungen 1520-1675		Zürcher Kirchenordnungen 1520-1675, hg. v. Philipp Wälchli und Emidio Campi, 2 Bde., Zürich 2011.
Kirchhofer (Kirchhofer, Myconius)	Oswald Myconius, Antistes der Baslerischen Kirche		Melchior Kirchhofer, Oswald Myconius, Antistes der Baslerischen Kirche, Zürich 1813.
Kirchhofer, Haller	Berthold Haller oder die Reformation von Bern		Melchior Kirchhofer, Berthold Haller oder die Reformation von Bern, Zürich 1828.
Kirchhoff	Die Belagerung und Eroberung Münsters 1534/35. Militärische Maßnahmen und politische Verhandlungen des Fürstbischofs Franz von Waldeck		Karl-Heinz Kirchhoff, Die Belagerung und Eroberung Münsters 1534/35. Militärische Maßnahmen und politische Verhandlungen des Fürstbischofs Franz von Waldeck, in: Westfälische Zeitschrift 112, 1962, S. 77-170.
Kirsch	Abundantissimum cornucopiae linguae Latinae et Germanicae selectum, quo continentur vocabula Latina omnis aevi		Adam Friedrich Kirsch, Abundantissimum cornucopiae linguae Latinae et Germanicae selectum, quo continentur vocabula Latina omnis aevi, Leipzig 1774.
Knittel, Thurgau-I (Knittel; Knittel, Reformation)	Die Reformation im Thurgau		Alfred L. Knittel, Die Reformation im Thurgau. Zum vierhundertjährigen Jubiläum hg. v. evangelischen Kirchenrat des Kantons Thurgau, Frauenfeld 1929.
Knittel, Thurgau-II (Knittel, Kirche)	Werden und Wachsen der evangelischen Kirche im Thurgau von der Reformation bis zum Landfrieden von 1712		Alfred L. Knittel, Werden und Wachsen der evangelischen Kirche im Thurgau von der Reformation bis zum Landfrieden von 1712. Bearb. im Auftrage des evangelischen Kirchenrates des Kantons Thurgau, Frauenfeld 1946.
Konstanz (Burkhardt/Dobras/Zimmermann)	Konstanz in der frühen Neuzeit. Reformation - Verlust der Reichsfreiheit - Österreichische Zeit		Martin Burkhardt, Wolfgang Dobras und Wolfgang Zimmermann, Konstanz in der frühen Neuzeit. Reformation - Verlust der Reichsfreiheit - Österreichische Zeit, Konstanz 1991 - Geschichte der Stadt Konstanz 3.
Krafft, HBKöln (Krafft)	Aufzeichnungen des schweizerischen Reformators Heinrich Bullinger über sein Studium zu Emmerich und Köln (1516-1522) und dessen Briefwechsel mit Freunden in Köln, Erzbischof Hermann von Wied etc. Ein Beitrag zur niederrheinisch-westfälischen Kirchen-, Schul- und Gelehrtengeschichte		Carl Krafft, Aufzeichnungen des schweizerischen Reformators Heinrich Bullinger über sein Studium zu Emmerich und Köln (1516-1522) und dessen Briefwechsel mit Freunden in Köln, Erzbischof Hermann von Wied etc. Ein Beitrag zur niederrheinisch-westfälischen Kirchen-, Schul- und Gelehrtengeschichte, Elberfeld 1870 (Sonderabdruck aus: Zeitschrift des Bergischen Geschichtsvereins 6, 1869, S. 193-340).
Krömer (Krömer, Aquilomontanus)	Der Briefwechsel des Hermannus Aquilomontanus mit Heinrich Bullinger		Eckart Krömer, Der Briefwechsel des Hermannus Aquilomontanus mit Heinrich Bullinger, in: Emder Jahrbuch für historische Landeskunde Ostfrieslands 87, 2007, S. 31-67.
Kuhaupt (Kuhaupt, Kirchenpolitik)	Veröffentlichte Kirchenpolitik. Kirche im publizistischen Streit zur Zeit der Religionsgespräche (1538-1541)		Georg Kuhaupt, Veröffentlichte Kirchenpolitik. Kirche im publizistischen Streit zur Zeit der Religionsgespräche (1538-1541), Göttingen 1998 - Forschungen zur Kirchen- und Dogmengeschichte 69.
Kutter (Kutter, Curione)	Celio Secondo Curione. Sein Leben und sein Werk (1503-1569)		Markus Kutter, Celio Secondo Curione. Sein Leben und sein Werk (1503-1569), Basel 1955 - Basler Beiträge zur Geschichtswissenschaft 54.
Köhler (Köhler, ZL)	Zwingli und Luther. Ihr Streit über das Abendmahl nach seinen politischen und religiösen Beziehungen		Walther Köhler, Zwingli und Luther. Ihr Streit über das Abendmahl nach seinen politischen und religiösen Beziehungen, 2 Bde., Leipzig 1924 / Gütersloh 1953 - QFRG 6f.
Köhler, Ehegericht	Zürcher Ehegericht und Genfer Konsistorium		Walther Köhler, Zürcher Ehegericht und Genfer Konsistorium, 2 Bde., Leipzig 1932/1942 - Quellen und Abhandlungen zur Schweizerischen Reformationsgeschichte 7 und 10.
Köhler, Hessen (Köhler, Hessen und die Schweiz)	Hessen und die Schweiz nach Zwinglis Tode im Spiegel gleichzeitiger Korrespondenzen		Walther Köhler, Hessen und die Schweiz nach Zwinglis Tode im Spiegel gleichzeitiger Korrespondenzen, in: Philipp der Großmütige. Beiträge zur Geschichte seines Lebens und seiner Zeit, hg. v. Historischen Verein für das Großherzogtum Hessen, Marburg 1904, S. 460-503.
König	Gazophylacium Latinitatis sive Lexicon novum Latino-Germanicum, in quo voces a Latinis scriptoribus iisque tam veteribus quam recentioribus usurpatae ... exhibentur		Georg Matthias König, Gazophylacium Latinitatis sive Lexicon novum Latino-Germanicum, in quo voces a Latinis scriptoribus iisque tam veteribus quam recentioribus usurpatae ... exhibentur, Nürnberg 1668.
LAW	Lexikon der Alten Welt		Lexikon der Alten Welt, hg. v. Carl Andresen u.a., Zürich/Stuttgart 1965 (Nachdruck: Zürich/München 1990).
LB	Desiderii Erasmi Roterodami opera omnia		Desiderii Erasmi Roterodami opera omnia, 10 Bde., Leiden 1703-1706 (Nachdruck: London 1962).
LHSz	Lateinische Grammatik		Manu Leumann, Johann Baptist Hofmann, Anton Szantyr, Lateinische Grammatik. Auf der Grundlage des Werkes von Friedrich Stolz und Joseph Hermann Schmalz, Bd. 1-3, München 1963-1979 - Handbuch der Altertumswissenschaft, 2. Abteilung, 2. Teil, Bd. 1-3.
LL	Allgemeines helvetisches, eydgenössisches oder schweitzerisches Lexicon		Hans Jacob Leu, Allgemeines helvetisches, eydgenössisches oder schweitzerisches Lexicon, 20 Teile, Zürich 1747-1765; 6 Supplementbände (Abk.: LL-Suppl.) von Hans Jacob Holzhalb, Zug 1786-1795.
LMA	Lexikon des Mittelalters		Lexikon des Mittelalters, 9 Bde. und Registerband, München u.a. 1980-1999.
LP	Letters and Papers, Foreign and Domestic, of the Reign of Henry VIII.		Letters and Papers, Foreign and Domestic, of the Reign of Henry VIII., Preserved in the Public Record Office, the British Museum and Elsewhere. Arranged and Catalogued by John Sherren Brewer, James Gairdner and Robert Henry Brodie, 21 Bde., London 1862-1910 (Nachdruck: Vaduz 1965).
LSRK	Leben und ausgewählte Schriften der reformierten Kirche		Leben und ausgewählte Schriften der reformierten Kirche, 10 Tle., Elberfeld 1857-1863.
LThK2 (LThK)	Lexikon für Theologie und Kirche		Lexikon für Theologie und Kirche, 2. Aufl., 10 Bde., Freiburg i. Br. 1957-1967.
LThK3 (LThK; LThK	Lexikon für Theologie und Kirche		Lexikon für Theologie und Kirche, 3. Aufl., 11 Bde., Freiburg i. Br. 1993-2001.
Lausberg	Handbuch der literarischen Rhetorik. Eine Grundlegung der Literaturwissenschaft		Heinrich Lausberg, Handbuch der literarischen Rhetorik. Eine Grundlegung der Literaturwissenschaft, 2 Bde., München 1960.
Lavater	Vom laͤben und tod deß Eerwirdigen und Hochgeleerten Herrn Heinrychen Bullingers / dieners der Kyrchen zuͦ Zürych /kurtze einfalte und warhaffte erzellung		Ludwig Lavater, Vom laͤben und tod deß Eerwirdigen und Hochgeleerten Herrn Heinrychen Bullingers / dieners der Kyrchen zuͦ Zürych /kurtze einfalte und warhaffte erzellung, Zürich 1576.
Lavater (Lavater, Täuferdisputation)	Berner Täuferdisputation 1538. Funktion, Gesprächsführung, Argumentation, Schriftgebrauch		Hans Rudolf Lavater, Berner Täuferdisputation 1538. Funktion, Gesprächsführung, Argumentation, Schriftgebrauch, in: "... lebenn nach der ler Jhesu ..." "Das sind aber wir!" Berner Täufer und Prädikanten im Gespräch 1538-1988, Bern 1989 - Informationsblätter, Schweizerischer Verein für Täufergeschichte 11/12.
Le Fur, Henri II	Henri II		Didier Le Fur, Henri II, Paris 2009.
Lengwiler	Die vorreformatorischen Prädikaturen der deutschen Schweiz. Von ihrer Entstehung bis 1530		Eduard Lengwiler, Die vorreformatorischen Prädikaturen der deutschen Schweiz. Von ihrer Entstehung bis 1530, Diss. phil., Freiburg/Schweiz 1955.
Lenz	Briefwechsel Landgraf Philipp's des Großmüthigen von Hessen mit Bucer		Briefwechsel Landgraf Philipp's des Großmüthigen von Hessen mit Bucer, hg. v. Max Lenz, 3 Bde., Leipzig 1880-1891 (Nachdruck: Osnabrück 1965) - Publikationen aus den Königlichen Preußischen Staatsarchiven 5. 28. 47.
Lenz, Bericht	Der Rechenschaftsbericht Philipps des Grossmüthigen über den Donaufeldzug 1546 und seine Quellen		Max Lenz, Der Rechenschaftsbericht Philipps des Grossmüthigen über den Donaufeldzug 1546 und seine Quellen, Marburg 1886.
Lenz, Kriegführung	Die Kriegführung der Schmalkaldener gegen Karl V. an der Donau		Max Lenz, Die Kriegführung der Schmalkaldener gegen Karl V. an der Donau, in: Historische Zeitschrift 49/3, 1883, 385-460.
Letters of Calvin	Letters of John Calvin. Compiled from the Original Manuscripts and Edited with Historical Notes by Jules Bonnet		Letters of John Calvin. Compiled from the Original Manuscripts and Edited with Historical Notes by Jules Bonnet [übersetzt von David Constable und Marcus Robert Gilchrist], Edinburgh-Philadelphia 1855-1858 (Nachdruck: Grand Rapids 1983).
Leu, Froschauer	Reformation als Auftrag: Der Zürcher Drucker Christoph Froschauer d.Ä.		Urs B. Leu, Reformation als Auftrag: Der Zürcher Drucker Christoph Froschauer d.Ä. (ca. 1490-1564), in: Zwa XLV, 2018, 1-80.
Leutsch/Schneidewin	Corpus paroemiographorum graecorum		Corpus paroemiographorum graecorum, hg. V. Ernst Ludwig von Leutsch und F. G. Schneidewin, Göttingen 1839/1851.
Lexer	Mittelhochdeutsches Handwörterbuch		Matthias Lexer, Mittelhochdeutsches Handwörterbuch, 3 Bde., Leipzig 1872-1878 (Nachdruck: Stuttgart 1979).
Lexutt	Rechtfertigung im Gespräch. Das Rechtfertigungsverständnis in den Religionsgesprächen von Hagenau, Worms und Regensburg 1540/41		Athina Lexutt, Rechtfertigung im Gespräch. Das Rechtfertigungsverständnis in den Religionsgesprächen von Hagenau, Worms und Regensburg 1540/41, Göttingen 1996 - Forschungen zur Kirchen- und Dogmengeschichte 64.
Ley	Kirchenzucht bei Zwinglich		Roger Ley, Kirchenzucht bei Zwinglich, Zürich (1948). - QAAGSP II.
Life, Early Writings and Eucharistic Writings of Peter Martyr		63	The Life, Early Letters and Eucharistic Writings of Peter Martyr. Introduced and edited by J. C. Mclelland and G. E. Duffield. The Courtenay Library of Reformation Classics. Oxford: Sutton Courtenay Press, 1989. iii 372 pp. Church History, 63(3), 499-499. doi:10.2307/3167593
Litz	Die reformatorische Bilderfrage in den schwäbischen Reichsstädten		Gudrun Litz, Die reformatorische Bilderfrage in den schwäbischen Reichsstädten, Tübingen 2007 - Spätmittelalter und Reformation, Neue Reihe 35.
Locher I	Grundzüge der Theologie Huldrich Zwinglis im Lichte seiner Christologie. Erster Teil: Die Gotteslehre		Gottfried W. Locher, Grundzüge der Theologie Huldrich Zwinglis im Lichte seiner Christologie. Erster Teil: Die Gotteslehre, Zürich 1952. - StDTh I.
Locher, Grundzüge	Grundzüge der Theologie Huldrych Zwinglis im Vergleich mit derjenigen Martin Luthers und Johannes Calvins		Gottfried W. Locher, Grundzüge der Theologie Huldrych Zwinglis im Vergleich mit derjenigen Martin Luthers und Johannes Calvins, in: Zwa XII 470-509. 545-595; [auch in: Gottfried W. Locher, Huldrych Zwingli in neuer Sicht. Zehn Beiträge zur Theologie der Zürcher Reformation, Zürich-Stuttgart 1969, S. 172-274].
Luther Bibl. (Benzing/Claus)	Lutherbibliographie		Josef Benzing und Helmut Claus, Lutherbibliographie, 2. Aufl., 2 Bde., Baden-Baden 1989/1994 - BBA 10. 143.
M-Basel (Basel, Matrikel)	Die Matrikel der Universität Basel		Die Matrikel der Universität Basel, hg. v. Hans Georg Wackernagel, 5 Bde., Basel 1951-1980.
M-Erfurt (Erfurt, Matrikel)	Acten der Erfurter Universität		Acten der Erfurter Universität, hg. v. Johann Christian Hermann Weissenborn, 3 Bde. (Bd. 3: Register zu den Jahren 1392-1636, bearb v. Adalbert Hortzschansky), Halle a. d. Saale 1881-1899 - Geschichtsquellen der Provinz Sachsen und angrenzender Gebiete VIII/1-3.
M-Freiburg (Freiburg, Matrikel)	Die Matrikel der Universität Freiburg im Breisgau von 1460-1656		Die Matrikel der Universität Freiburg im Breisgau von 1460-1656, bearb. und hg. v. Hermann Mayer, 2 Bde., Freiburg i. Br. 1907/1910 (Nachdruck: Nendeln 1976).
M-Heidelberg (Heidelberg, Matrikel)	Gustav Toepke und Paul Hintzelmann		Gustav Toepke und Paul Hintzelmann, Die Matrikel der Universität Heidelberg. Bd. 1: Von 1386 bis 1553; Bd. 2: Von 1554 bis 1662; Bd. 3: Personenregister, Ortsregister, Sach- und Wörterregister, Heidelberg 1884-1893.
M-Ingolstadt (Ingolstadt, Matrikel)	Die Matrikel der Ludwig-Maximilians-Universität Ingolstadt-Landshut-München		Die Matrikel der Ludwig-Maximilians-Universität Ingolstadt-Landshut-München, hg. v. Götz Freiherrn von Pölnitz, fortgeführt von Laetitia Boehm, Teil I: Ingolstadt, 5 Bde., München 1937-1984.
M-Jena (Jena, Matrikel I)	Die Matrikel der Universität Jena		Die Matrikel der Universität Jena, Bd. 1: 1548-1652, bearb. v. Georg Mentz in Verbindung mit Reinhold Jauernig, Jena 1944 - Veröffentlichungen der Thüringischen Historischen Kommission 1.
M-Köln (Matrikel, Köln; Köln, Matrikel)	Die Matrikel der Universität Köln		Die Matrikel der Universität Köln, bearb. v. Hermann Keussen, 3 Bde., Bonn 1892-1931 - Publikationen der Gesellschaft für rheinische Geschichtskunde VIII/1-3.
M-Leipzig (Leipzig, Matrikel)	Die Matrikel der Universität Leipzig		Die Matrikel der Universität Leipzig. Im Auftrag der Königlich Sächsischen Staatsregierung hg. v. Georg Erler, 3 Bde., Leipzig 1895-1902 (Nachdruck: Nendeln 1976).
M-Marburg	Catalogi studiosorum scholae Marpurgensis antiquissimi particula		Catalogi studiosorum scholae Marpurgensis antiquissimi particula, hg. v. Carolus Julius Caesar, 8 Teile, Marburg 1872-1880.
M-Marburg/Reg (Falckenheiner)	Personen- und Ortsregister zu der Matrikel und den Annalen der Universität Marburg 1527-1652		Wilhelm Falckenheiner, Personen- und Ortsregister zu der Matrikel und den Annalen der Universität Marburg 1527-1652, Marburg 1904.
M-Montpellier (Montpellier, Matrikel)	Matricule de l'Université de médecine de Montpellier (1503-1599)		Matricule de l'Université de médecine de Montpellier (1503-1599), hg. v. Marcel Gouron, Genf 1957 - THR 25.
M-Oxford/1 (Emden, I-III)	A Biographical Register of the University of Oxford to A. D. 1500		Alfred Brotherston Emden, A Biographical Register of the University of Oxford to A. D. 1500, 3 Bde., Oxford 1957-1959.
M-Oxford/2 (Emden)	A Biographical Register of the University of Oxford A. D. 1501 to 1540		Alfred Brotherston Emden, A Biographical Register of the University of Oxford A. D. 1501 to 1540, Oxford 1974.
M-Tübingen (Tübingen, Matrikel)	Die Matrikeln der Universität Tübingen	1	Die Matrikeln der Universität Tübingen, hg. v. Heinrich Hermelink, Bd. 1: Die Matrikeln von 1477-1600, Stuttgart 1906.
M-Wien (Wien, Matrikel)	Die Matrikel der Universität Wien, Graz u.a.		Die Matrikel der Universität Wien, Graz u.a. 1956ff - Publikationen des Instituts für Österreichische Geschichtsforschung, VI. Reihe: Quellen zur Geschichte der Universität Wien, 1. Abt.
M-Wittenberg (Wittenberg, Matrikel)	Album Academiae Vitebergensis ab a. Ch. MDII usque ad a. MDLX		Album Academiae Vitebergensis ab a. Ch. MDII usque ad a. MDLX, hg. v. Karl Eduard Förstemann, Otto Hartwig und Karl Gerhard, Leipzig 1841 (Bd. 1); Halle a. d. Saale 1894/1905 (Bde., 2f) (Nachdruck: Aalen 1976).
MAGZ	Mitteilungen der Antiquarischen Gesellschaft in Zürich		Mitteilungen der Antiquarischen Gesellschaft in Zürich, Zürich 1837ff.
MBW	Melanchthons Briefwechsel. Kritische und kommentierte Gesamtausgabe.	1	Melanchthons Briefwechsel. Kritische und kommentierte Gesamtausgabe, hg. v. Heinz Scheible, Bd. 1ff, Stuttgart/Bad Cannstatt 1977ff.
MBW-Reg (MBW, Regesten; Melanchthon BW, Regesten)	Melanchthons Briefwechsel. Kritische und kommentierte Gesamtausgabe. Regesten.		Melanchthons Briefwechsel. Kritische und kommentierte Gesamtausgabe. Regesten. Im Auftrag der Heidelberger Akademie der Wissenschaften hg. v. Heinz Scheible, Bd. 1ff, Stuttgart/Bad Cannstatt 1977ff.
MBW-T (MBW, Texte)	Melanchthons Briefwechsel. Kritische und kommentierte Gesamtausgabe. Texte.		Melanchthons Briefwechsel. Kritische und kommentierte Gesamtausgabe. Texte. Im Auftrag der Heidelberger Akademie der Wissenschaften hg. v. Heinz Scheible; ab Bd. 11 hg. v. Christine Mundhenk, Bd. 1ff, Stuttgart/Bad Cannstatt 1991ff.
ME (Mennonite Encyclopedia)	The Mennonite Encyclopedia. A Comprehensive Reference Work on the Anabaptist-Mennonite Movement		The Mennonite Encyclopedia. A Comprehensive Reference Work on the Anabaptist-Mennonite Movement, hg. v. Harold S. Bender u.a., 5 Bde., Scottdale, Pennsylvania, 1955-1990.
MGEGDE2 (MGEGDE	Mittheilungen der Gesellschaft für Erhaltung der Geschichtlichen Denkmäler im Elsass	2	Mittheilungen der Gesellschaft für Erhaltung der Geschichtlichen Denkmäler im Elsass, 2. Folge, Straßburg 1870-1912.
MGH-Ep (MGH.Ep)	Monumenta Germaniae Historica. Epistolae		Monumenta Germaniae Historica. Epistolae, Berlin 1887ff.
MGH-LNG (MGH.LNG)	Monumenta Germaniae Historica. Leges nationum Germanicarum		Monumenta Germaniae Historica. Leges nationum Germanicarum, Hannover 1886ff.
MGH-PL (MGH.PL)	Monumenta Germaniae Historica. Poetae Latini medii aevi		Monumenta Germaniae Historica. Poetae Latini medii aevi, Berlin u.a. 1881ff.
MGH-S (MGH.SS)	Monumenta Germaniae Historica. Scriptores		Monumenta Germaniae Historica. Scriptores, Hannover 1826ff.
ML	Mennonitisches Lexikon		Mennonitisches Lexikon, 4 Bde., Frankfurt a.M. - Weierhof/Pfalz 1913/1937, Karlsruhe 1958/1967.
MLW	Mittellateinisches Wörterbuch		Mittellateinisches Wörterbuch, hrsg. von der Bayerischen Akademie der Wissenschaften, München, 1959ff.
MO	Philippi Melanthonis opera quae supersunt omnia		Philippi Melanthonis opera quae supersunt omnia, hg. v. Carolus Gottlieb Bretschneider, Henricus Ernestus Bindseil, 28 Bde., Halle a. d. Saale/Braunschweig 1835-1860 - CR I-XXVIII (Nachdruck: New York u.a. 1963).
MPG	Patrologia Graeca		Patrologia Graeca, hg. v. Jacques Paul Migne, 162 Bde. und 1 Registerband, Paris 1857-1912.
MPL	Patrologia Latina		Patrologia Latina, hg. v. Jacques Paul Migne, 217 Bde. und 4 Register-Bde., Paris 1878-1890; Supplementum, 5 Bde., Paris 1958-1974.
MQR	The Mennonite Quarterly Review		The Mennonite Quarterly Review, Goshen 1927ff.
MVG	Mitteilungen zur vaterländischen Geschichte		Mitteilungen zur vaterländischen Geschichte, hg. v. Historischen Verein des Kantons St. Gallen, St. Gallen 1862ff.
MWA (MSA)	Melanchthons Werke in Auswahl (Studienausgabe)		Melanchthons Werke in Auswahl (Studienausgabe), hg. v. Robert Stupperich u.a., 7 Teile in 9 Bden., Gütersloh 1951-1975.
MacCulloch, Cranmer	Thomas Cranmer. A Life		Diarmaid MacCulloch, Thomas Cranmer. A Life, New Haven/London 1996.
Maeder, Unruhe	Die Unruhe der Zürcher Landschaft nach Kappel (1531/1532) oder: Aspekte einer Herrschaftskrise		Kurt Maeder, Die Unruhe der Zürcher Landschaft nach Kappel (1531/1532) oder: Aspekte einer Herrschaftskrise, in: Zwa XIV 109-144.
Maeder, Via Media	Die Via Media in der Schweizerischen Reformation. Studien zum Problem der Kontinuität im Zeitalter der Glaubensspaltung		Kurt Maeder, Die Via Media in der Schweizerischen Reformation. Studien zum Problem der Kontinuität im Zeitalter der Glaubensspaltung, Zürich 1970. - ZBRG II.
Mameranus, Exerc.	Catalogus omnium generalium, tribunorum, ducum, primorumque totius Exercitus Caroli V. imperatoris augusti et Ferdinandi Regis Romanorum super rebelleis et inobedienteis Germaniae quosdam principes ac civitates conscripti anno 1546		Nicolaus Mameranus, Catalogus omnium generalium, tribunorum, ducum, primorumque totius Exercitus Caroli V. imperatoris augusti et Ferdinandi Regis Romanorum super rebelleis et inobedienteis Germaniae quosdam principes ac civitates conscripti anno 1546, Köln, Heinrich Mameranus, 1550.
Mameranus, Fam.	Catalogus familiae totius aulae Caesareae per expeditionem adversus inobedientes ... anno. 1547 et 1548		Nicolaus Mameranus, Catalogus familiae totius aulae Caesareae per expeditionem adversus inobedientes ... anno. 1547 et 1548, Köln, Heinrich Mameranus, 1550.
Mameranus, Heer	Des gantzen Heerzugs Römischer Kayserlichen Mayestät jüngst volfürter Kriegsrüstung ... mit sonderlicher Erzelung der Namen aller Obersten, Comissarien, Hauptleuten und Befehlhaber ...		Nicolaus Mameranus, Des gantzen Heerzugs Römischer Kayserlichen Mayestät jüngst volfürter Kriegsrüstung ... mit sonderlicher Erzelung der Namen aller Obersten, Comissarien, Hauptleuten und Befehlhaber ..., [Würzburg, Johann Müller], 1548.
Mameranus, Rebel.	Catalogus expeditionis rebellium principum ac civitatum Germaniae sub duobus potissimum generalibus praefectis, Iohanne Friderico, Duce Electore Saxoniae, et Philippo Lantgravio Hessiae contra Carolum V. ... conscriptae et productae anno. 1546		Nicolaus Mameranus, Catalogus expeditionis rebellium principum ac civitatum Germaniae sub duobus potissimum generalibus praefectis, Iohanne Friderico, Duce Electore Saxoniae, et Philippo Lantgravio Hessiae contra Carolum V. ... conscriptae et productae anno. 1546, Köln, Heinrich Mameranus, 1550.
Manuel	Niklaus Manuel	2	Niklaus Manuel, hg. v. Jakob Bächtold, Frauenfeld 1878. - Bibliothek älterer Schriftwerke der deutschen Schweiz und ihres Grenzgebietes, Bd. II.
Marburg, Matrikel II	Diem natalem augustissimi et potentissimi imperatoris ac regis Guilielmi I. ab academia Marburgensi … oratione in aula gymnasii habenda celebrandum indicit Carolus Julius Caesar. Inest catalogi studiosorum scholae Marpurgensis antiquissimi particula altera		Diem natalem augustissimi et potentissimi imperatoris ac regis Guilielmi I. ab academia Marburgensi … oratione in aula gymnasii habenda celebrandum indicit Carolus Julius Caesar. Inest catalogi studiosorum scholae Marpurgensis antiquissimi particula altera, Marburg [1874].
Marmor, Übergabe	Die Übergabe der Stadt Konstanz an's Haus Österreich im J. 1548	47	Johannes Marmor, Die Übergabe der Stadt Konstanz an's Haus Österreich im J. 1548. Aus dem Archive der Stadt Konstanz, in: Sitzungsberichte der Philosophisch-Historischen Classe der Kaiserlichen Akademie der Wissenschaften, Bd. 47, Wien 1864, H. I und II, S. 278-314.
Mattausch	Die Reichsstadt Straßburg im Schmalkaldischen Bund am Vorabend des Krieges von 1546/47		Rudolf Mattausch, Die Reichsstadt Straßburg im Schmalkaldischen Bund am Vorabend des Krieges von 1546/47, Diss. der Philosophischen Fakultät der Albert-Ludwigs-Universität zu Freiburg i.Br., Freiburg [1954] (Maschinenschrift).
Maurer, Übergang	Der Übergang der Stadt Konstanz an das Haus Oesterreich nach dem schmalkaldischen Kriege		Anton Maurer, Der Übergang der Stadt Konstanz an das Haus Oesterreich nach dem schmalkaldischen Kriege, in: Schriften des Vereins für Geschichte des Bodensees und seiner Umgebung 33, 1904, 3-86.
Melanchthon-Bibliogr.	Melanchthon-Bibliographie, 1510-1560		Helmut Claus, Melanchthon-Bibliographie, 1510-1560, 4 Bde., Gütersloh 2014 - Quellen und Forschungen zur Reformationsgeschichte 87/1-4.
Memorabilia Tigurina	Memorabilia Tigurina oder Merckwürdigkeiten der Stadt und Landschafft Zürich in alphabetischer Ordnung, enthaltend was sich vom Ursprung der Stadt biß auf Anno 1710 in dem Regiment, in Kirchen und Schulen ... zugetragen		Memorabilia Tigurina oder Merckwürdigkeiten der Stadt und Landschafft Zürich in alphabetischer Ordnung, enthaltend was sich vom Ursprung der Stadt biß auf Anno 1710 in dem Regiment, in Kirchen und Schulen ... zugetragen, bearbeitet von Hans Heinrich Bluntschli u.a., Zürich 1742.
Mentz	Johann Friedrich der Grossmütige 1503-1554		Georg Mentz, Johann Friedrich der Grossmütige 1503-1554, 3 Bde., Jena 1903-1908 - Beiträge zur neueren Geschichte Thüringens 1.
Meyer, Kappel (Meyer, Der Zweite Kappeler Krieg)	Der Zweite Kappeler Krieg. Die Krise der Schweizerischen Reformation		Helmut Meyer, Der Zweite Kappeler Krieg. Die Krise der Schweizerischen Reformation, Zürich 1976.
Meyer, Kollatur (Meyer, Zürich und Rom)	Zürich und Rom. Ordentliche Kollatur und päpstliche Provisionen am Frau- und Grossmünster 1316-1523		Andreas Meyer, Zürich und Rom. Ordentliche Kollatur und päpstliche Provisionen am Frau- und Grossmünster 1316-1523, Tübingen 1986 - Bibliothek des Deutschen Historischen Instituts in Rom 64.
Meyer, Loc/1 (Meyer, Locarno)	Die evangelische Gemeinde in Locarno, ihre Auswanderung nach Zürich und ihre weitern Schicksale. Ein Beitrag zur Geschichte der Schweiz im sechszehnten Jahrhundert nach bisher meist unbenutzten handschriftlichen Quellen		Ferdinand Meyer, Die evangelische Gemeinde in Locarno, ihre Auswanderung nach Zürich und ihre weitern Schicksale. Ein Beitrag zur Geschichte der Schweiz im sechszehnten Jahrhundert nach bisher meist unbenutzten handschriftlichen Quellen, 2 Bde., Zürich 1836.
Meyer, Locarno	La comunità riformata di Locarno e il suo esilio a Zurigo nel XVI secolo		Ferdinand Meyer, La comunità riformata di Locarno e il suo esilio a Zurigo nel XVI secolo, übersetzt von Brigitte Schwarz, Rom 2005.
MiscTig. (Misc. Tig.)	Miscellanea Tigurina edita, inedita, vetera, nova, theologica, historica, etc.		Miscellanea Tigurina edita, inedita, vetera, nova, theologica, historica, etc., hg. v. Johann Jakob Ulrich, 3 Bde., Zürich 1722-1724.
Moeller, Zwick	Johannes Zwick und die Reformation in Konstanz		Bernd Moeller, Johannes Zwick und die Reformation in Konstanz, Gütersloh 1961 - QFRG 28.
Moritz von Sachsen PK	Politische Korrespondenz des Herzogs und Kurfürsten Moritz von Sachsen		Politische Korrespondenz des Herzogs und Kurfürsten Moritz von Sachsen, hg. v. Erich Brandenburg (Bde. 1f), Johannes Herrmann und Günther Wartenberg (Bde. 3-6) sowie Christian Winter (Bde. 5f), 6 Bde., Leipzig und (ab Bd. 3) Berlin 1900-2006.
Moser, Bullinger	Die Dignität des Ereignisses. Studien zu Heinrich Bullingers Reformationsgeschichtsschreibung		Christian Moser, Die Dignität des Ereignisses. Studien zu Heinrich Bullingers Reformationsgeschichtsschreibung, 2 Bde., Leiden 2012 - Studies in the History of Christian Traditions 163.
Mühling (Mühling, Kirchenpolitik)	Heinrich Bullingers europäische Kirchenpolitik		Andreas Mühling, Heinrich Bullingers europäische Kirchenpolitik, Bern u.a. 2001 - ZBRG 19.
Mülinen, Kriegsberichte	Waadtländische Kriegsberichte des Hans Franz Nägeli		Wolfang von Mülinen, Waadtländische Kriegsberichte des Hans Franz Nägeli, in: Archiv des Historischen Vereins des Kantons Bern XII, 1899, S. 253-281.
Müller	Die römische Kurie und die Reformation 1523-1534. Kirche und Politik während des Pontifikats Clemens’ VII.		Gerhard Müller, Die römische Kurie und die Reformation 1523-1534. Kirche und Politik während des Pontifikats Clemens’ VII., Gütersloh 1969. - QFRG XXXVIII.
Müller, Quellen	Die Quellen zur Beschreibung des Zürich- und Aargaus in Johannes Stumpfs Schweizerchronik		Gustav Müller, Die Quellen zur Beschreibung des Zürich- und Aargaus in Johannes Stumpfs Schweizerchronik, hg. durch die Stiftung Schnyder von Wartensee, Zürich 1916.
NBD	Nuntiaturberichte aus Deutschland nebst ergänzenden Aktenstücken. Erste Abteilung 1533-1559		Nuntiaturberichte aus Deutschland nebst ergänzenden Aktenstücken. Erste Abteilung 1533-1559, Gotha u.a. 1892ff.
NDB	Neue Deutsche Biographie		Neue Deutsche Biographie, hg. v. der Historischen Kommission bei der Bayerischen Akademie der Wissenschaften, Berlin 1953ff.
NDBA	Nouveau dictionnaire de biographie alsacienne		Nouveau dictionnaire de biographie alsacienne, 49 Hefte, Straßburg 1982-2007.
Naef, Genève	Les Origines de la Réforme à Genève, tome II, L'Ère de la triple Combourgeoisie, l'Épée ducale et l'Épée de Farel		Henri Naef, Les Origines de la Réforme à Genève, tome II, L'Ère de la triple Combourgeoisie, l'Épée ducale et l'Épée de Farel, Genf 1968. - Traveaux d’Humanisme et Renaissance C, 2.
Netoliczka, Honterus (Netoliczka, Bullingerbrief)	Der Bullingerbrief an Honterus und Martinus Hentius Transylvanus		Oskar Netoliczka, Der Bullingerbrief an Honterus und Martinus Hentius Transylvanus, in: Festschrift seiner Hochwürden D. Dr. Friedrich Teutsch gewidmet zu seinem 25jährigen Bischofs-Jubiläum vom Ausschuss des Vereins für siebenbürgische Landeskunde, Hermannstadt 1931, S. 179-190.
Neudecker	Merkwürdige Aktenstücke aus dem Zeitalter der Reformation		Merkwürdige Aktenstücke aus dem Zeitalter der Reformation, hg. v. Christian Gotthold Neudecker, Zweite Abtheilung, Nürnberg 1838.
Neuser, Vorbereitung	Die Vorbereitung der Religionsgespräche von Worms und Regensburg 1540/41		Wilhelm H. Neuser, Die Vorbereitung der Religionsgespräche von Worms und Regensburg 1540/41, Neukirchen/Vluyn 1974 - Texte zur Geschichte der evangelischen Theologie 4.
Niehans, Bullinger-Briefsammlung	Die Bullinger-Briefsammlung		Max Niehans, Die Bullinger-Briefsammlung, in: Zwa VIII/3, 1945, S. 141-167.
Niermeyer	Mediae Latinitatis lexicon minus		Mediae Latinitatis lexicon minus, hg. v. Jan Frederik Niermeyer und Co van de Kieft, überarbeitet von Johannes Willem Jozef Burgers, 2. Aufl., 2 Bde., Darmstadt/Leiden 2002.
Notes on the Consensus Tigurinus of 1549	Concordia Theological Monthly	20	Mueller, John Theodore (1949) "Notes on the Consensus Tigurinus of 1549," Concordia Theological Monthly: Vol. 20, Article 73.
Näf, Vadian	Vadian und seine Stadt St. Gallen		Werner Näf, Vadian und seine Stadt St. Gallen, 2 Bde., St. Gallen 1944/1957.
ODNB (Oxford DNB)	Oxford Dictionary of National Biography, from the Earliest Times to the Year 2000		Oxford Dictionary of National Biography, from the Earliest Times to the Year 2000, hg. v. Henry Colin Gray Matthew und Brian Harrison, 60 Bde., Oxford 2004ff.
OER	The Oxford Encyclopedia of the Reformation		The Oxford Encyclopedia of the Reformation, 4 Bde., New York/Oxford 1996.
Oekolampad BA	Briefe und Akten zum Leben Oekolampads		Briefe und Akten zum Leben Oekolampads. Zum vierhundertjährigen Jubiläum der Basler Reformation bearb. v. Ernst Staehelin, 2 Bde., Leipzig 1927/1934 - QFRG 10. 19.
Oekolampad Bibl. (Oekolampad-Bibliographie)	Oekolampad-Bibliographie		Ernst Staehelin, Oekolampad-Bibliographie, Basel 1918, 2. unv. Aufl., Nieuwkoop 1963.
Opera Calvini	Ioannis Calvini opera quae supersunt omnia		Ioannis Calvini opera quae supersunt omnia, hg. v. Guilielmus Baum, Eduardus Cunitz, Eduardus Reuss, 59 Bde., Braunschweig/Berlin 1863-1900 - CR XXIX-LXXXVII.
Original Letters	Original Letters Relative to the English Reformation, Written During the Reigns of King Henry VIII., King Edward VI., and Queen Mary		Original Letters Relative to the English Reformation, Written During the Reigns of King Henry VIII., King Edward VI., and Queen Mary: Chiefly from the Archives of Zurich. Translated and Edited by the Rev. Hastings Robinson. 2 Bde., Cambridge 1846/1847 (Nachdruck: New York 1968).
Orléans, Nat. germ.	Premier livre des procurateurs de la Nation germanique de l'ancienne Université d'Orléans, 1444-1546	1	Premier livre des procurateurs de la Nation germanique de l'ancienne Université d'Orléans, 1444-1546, hg. v. Detlef Illmer, Cornelia M. Ridderikhoff und Hilde de Ridder-Symoens, I. Teil in 4 Bde., Leiden 1971-1985 (abgekürzt Orléans, Nat. germ. I/1-4). - Deuxième livre des procurateurs de la Nation germanique de l'ancienne Université d'Orléans, 1546-1560, hg. v. Chris L. Heesakkers und Cornelia M. Ridderikhoff, II. Teil in 2 Bde., Leiden 1988 (abgekürzt Orléans, Nat. germ. II/1-2).
Ortmann, Bucer (Ortmann, Reformation)	Reformation und Einheit der Kirche. Martin Bucers Einigungsbemühungen bei den Religionsgesprächen in Leipzig, Hagenau, Worms und Regensburg 1539-1541		Volkmar Ortmann, Reformation und Einheit der Kirche. Martin Bucers Einigungsbemühungen bei den Religionsgesprächen in Leipzig, Hagenau, Worms und Regensburg 1539-1541, Mainz 2001 - Veröffentlichungen des Instituts für Europäische Geschichte Mainz, Abteilung für Abendländische Religionsgeschichte 185.
Osiander GA	Andreas Osiander d.Ä., Gesamtausgabe		Andreas Osiander d.Ä., Gesamtausgabe. Im Auftrag der Heidelberger Akademie der Wissenschaften hg. v. Gerhard Müller und Gottfried Seebaß, 10 Bde., Gütersloh 1975-1997.
Otto	Die Sprichwörter und sprichwörtlichen Redensarten der Römer		Die Sprichwörter und sprichwörtlichen Redensarten der Römer, gesammelt und erklärt von August Otto, Leipzig 1890 (Nachdruck: Hildesheim 1962).
PA	Politisches Archiv des Landgrafen Philipp des Großmütigen von Hessen. Inventar der Bestände		Politisches Archiv des Landgrafen Philipp des Großmütigen von Hessen. Inventar der Bestände, Bde. 1-2, hg. v. Friedrich Küch, Leipzig 1904/1910 - Publikationen aus den K. Preußischen Staatsarchiven 78. 85 (Nachdruck: Osnabrück 1965); Bde. 3-4, bearb. v. Walter Heinemeyer, Marburg 1954/1959 - Veröffentlichungen der Historischen Kommission für Hessen und Waldeck 24/1-2.
PC	Politische Correspondenz der Stadt Strassburg im Zeitalter der Reformation		Politische Correspondenz der Stadt Strassburg im Zeitalter der Reformation, 5 Bde., bearb. v. Hans Virck, Otto Winckelmann, Harry Gerber und Walter Friedensburg, Straßburg/Heidelberg 1882-1933.
Paillard	L'invasion allemande en 1544		Charles Paillard, L'invasion allemande en 1544, Paris 1884.
Pariset, Relations	Humanisme - Réforme et diplomatie. Les relations entre la France et l'Allemagne au milieu du XVI		Jean-Daniel Pariset, Humanisme - Réforme et diplomatie. Les relations entre la France et l'Allemagne au milieu du XVI
Pastor	Geschichte der Päpste seit dem Ausgang des Mittelalters	5	Ludwig von Pastor, Geschichte der Päpste seit dem Ausgang des Mittelalters, Bd. 5: Geschichte Papst Pauls III. (1534-1549), 5.-7. Aufl., Freiburg i. Br. 1923.
Paulus, Schertlin	Sebastian Schertlin von Burtenbach im Schmalkaldischen Krieg		Christof Paulus, Sebastian Schertlin von Burtenbach im Schmalkaldischen Krieg, in: Zeitschrift für bayerische Landesgeschichte 67/1, 2004, 47-84.
Pauly/Wissowa	Paulys Realencyclopädie der classischen Altertumswissenschaft. Neue Bearbeitung		Paulys Realencyclopädie der classischen Altertumswissenschaft. Neue Bearbeitung hg. v. Georg Wissowa u.a., Stuttgart 1894ff.
Peachey	Soziale Herkunft der Schweizer Täufer in der Reformationszeit. Eine religionssoziologische Untersuchung		Paul Peachey, Soziale Herkunft der Schweizer Täufer in der Reformationszeit. Eine religionssoziologische Untersuchung, Karlsruhe 1954. - Schriftenreihe des Mennonitischen Geschichtsvereins , Nr. 4.
Pellikan, Chronikon	Das Chronikon des Konrad Pellikan		Das Chronikon des Konrad Pellikan, hg. v. Bernhard Riggenbach, Basel 1877.
Pestalozzi	Heinrich Bullinger. Leben und ausgewählte Schriften. Nach handschriftlichen und gleichzeitigen Quellen		Carl Pestalozzi, Heinrich Bullinger. Leben und ausgewählte Schriften. Nach handschriftlichen und gleichzeitigen Quellen, Elberfeld 1858 - Leben und ausgewählte Schriften der Väter und Begründer der reformirten Kirche 5. LSRK V
Pestalozzi, Gegner Zwinglis	Die Gegner Zwinglis am Großmünsterstift in Zürich		Theodor Pestalozzi, Die Gegner Zwinglis am Großmünsterstift in Zürich. Der erste Teil einer Arbeit über: Die katholische Opposition gegen Zwingli in der Stadt und Landschaft Züric, 1519-1531, mit einer Einleitung zur Gesamtarbeit, Zürich 1918.
Pestalozzi, Haller	Berthold Haller. Nach handschriftlichen und gleichzeitigen Quellen		Carl Pestalozzi, Berthold Haller. Nach handschriftlichen und gleichzeitigen Quellen, Elberfeld 1860. - LSRK IX.
Pestalozzi, Jud	Leo Judä, nach handschriftlichen und gleichzeitigen Quellen		Carl Pestalozzi, Leo Judä, nach handschriftlichen und gleichzeitigen Quellen, Elberfeld 1960. - LSRK IX.
Pestalozzi, Lavater	Hans Rudolf Lavater, Bürgermeister, 1491-1557		[Carl Pestalozzi,] Hans Rudolf Lavater, Bürgermeister, 1491-1557, in: Njbl. zum Besten des Waisenhauses in Zürich 1864, [Zürich 1863] - 86. Njbl. von der Chorherrenstube.
Petritsch, Regesten	Regesten der osmanischen Dokumente im österreichischen Staatsarchiv		Ernst Dieter Petritsch, Regesten der osmanischen Dokumente im österreichischen Staatsarchiv, Bd. 1: 1480-1574, Wien 1991 - Mitteilungen des österreichischen Staatsarchivs 10/1.
Petrus Hisp., Summulae (Petrus Hispanus, Summulae logicales)	Petris Hispani Summulae logicales		Petris Hispani Summulae logicales, ed. I. M. Bochenski, Rom 1947.
Peuckert, Franck	Sebastian Franck. Ein deutscher Sucher		Will-Erich Peuckert, Sebastian Franck. Ein deutscher Sucher, München 1943.
Pf-Aargau (Pfister)	Die Prädikanten des bernischen Aargaus im 16.-18. Jh., 1528-1798		Willy Pfister, Die Prädikanten des bernischen Aargaus im 16.-18. Jh., 1528-1798, Zürich 1943 - Quellen und Studien zur Geschichte der helvetischen Kirche 11.
Pf-Ansbach	Ansbachisches Pfarrerbuch. Die Evangelisch-Lutherische Geistlichkeit des Fürstentums Brandenburg-Ansbach 1528-1806		Matthias Simon, Ansbachisches Pfarrerbuch. Die Evangelisch-Lutherische Geistlichkeit des Fürstentums Brandenburg-Ansbach 1528-1806, Nürnberg 1957 - Einzelarbeiten aus der Kirchengeschichte Bayerns 28.
Pf-Appenzell1	Die appenzellische reformierte Pfarrerschaft seit dem Bestehen jeder reformierten Kirchgemeinde bis 1977 zusammengestellt und mit biographischen Notizen versehen, mit einer kurz gefassten Geschichte der Synode von Appenzell A. Rh.		Hans-Martin Stückelberger, Die appenzellische reformierte Pfarrerschaft seit dem Bestehen jeder reformierten Kirchgemeinde bis 1977 zusammengestellt und mit biographischen Notizen versehen, mit einer kurz gefassten Geschichte der Synode von Appenzell A. Rh., Herisau 1977.
Pf-Appenzell2 (Stückelberger/Hirzel)	Die Pfarrerschaft der evangelisch-reformierten Landeskirche beider Appenzell		Hans-Martin Stückelberger, Die Pfarrerschaft der evangelisch-reformierten Landeskirche beider Appenzell, bearb. v. Willy Hirzel, Wald 1991.
Pf-Augsburg	Augsburger Pfarrerbuch. Die evangelischen Geistlichen der Reichsstadt Augsburg, 1524-1806		Hans Wiedemann, Augsburger Pfarrerbuch. Die evangelischen Geistlichen der Reichsstadt Augsburg, 1524-1806, Nürnberg 1962 - Einzelarbeiten aus der Kirchengeschichte Bayerns 28.
Pf-BadenWürtt	Baden-Württembergisches Pfarrerbuch		Baden-Württembergisches Pfarrerbuch, hg. im Auftrag des Vereins für Kirchengeschichte in der Evangelischen Landeskirche in Baden und des Vereins für Württembergische Kirchengeschichte, Karlsruhe/Stuttgart 1979ff.
Pf-Basel	Basilea reformata. Die Gemeinden der Kirche Basel Stadt und Land und ihre Pfarrer seit der Reformation bis zur Gegenwart		Karl Gauß, Basilea reformata. Die Gemeinden der Kirche Basel Stadt und Land und ihre Pfarrer seit der Reformation bis zur Gegenwart, Basel 1930.
Pf-Bern (Lohner)	Die reformierten Kirchen und ihre Vorsteher im eidgenössischen Freistaate Bern		Carl Friedrich Ludwig Lohner, Die reformierten Kirchen und ihre Vorsteher im eidgenössischen Freistaate Bern, Thun s.a. [1865].
Pf-Graubünden (Pfarrerbuch Graubünden)	Die Pfarrer der evang. Gemeinden in Graubünden und seinen ehemaligen Untertanenlanden		Die Pfarrer der evang. Gemeinden in Graubünden und seinen ehemaligen Untertanenlanden, bearb. v. Jakob Rudolf Truog, Chur s.a. (Sonderabdruck aus den Jahresberichten 1934/1935 der Historisch-Antiquarischen Gesellschaft von Graubünden).
Pf-Hessen (Hütteroth)	Die althessischen Pfarrer der Reformationszeit. Mit Nachträgen und Verzeichnissen von Hilmar Milbradt		Oskar Hütteroth, Die althessischen Pfarrer der Reformationszeit. Mit Nachträgen und Verzeichnissen von Hilmar Milbradt, Marburg 1966 - Veröffentlichungen der Historischen Kommission für Hessen und Waldeck 22.
Pf-Memmingen	Memminger Pfarrerbuch		Hermann Erhard, Memminger Pfarrerbuch, Neustadt a.d. Aisch 1977 - Einzelarbeiten aus der Kirchengeschichte Bayerns 55.
Pf-Neuburg	Neuburgisches Pfarrerbuch		[Maximilian] Weigel, [Joseph] Wopper, [Hans] Ammon, Neuburgisches Pfarrerbuch, Kallmünz 1967.
Pf-Pfalz (Pfälzisches Pfarrerbuch)	Die evangelischen Geistlichen der Pfalz seit der Reformation (Pfälzisches Pfarrerbuch)		Die evangelischen Geistlichen der Pfalz seit der Reformation (Pfälzisches Pfarrerbuch), bearb. v. Georg Biundo, Neustadt a. d. Aisch 1968 - Genealogie und Landesgeschichte 15.
Pf-Schwaben (Pfarrerbuch Bayerisch-Schwaben)	Pfarrerbuch Bayerisch-Schwaben		Pfarrerbuch Bayerisch-Schwaben (ehemalige Territorien Grafschaft Oettingen, Reichsstädte Augsburg, Donauwörth, Kaufbeuren, Kempten, Lindau, Memmingen, Nördlingen und Pfarreien der Reichsritterschaft in Schwaben), bearb. v. Helene Burger, Hermann Erhard und Hans Wiedemann, zusammengestellt von Hans Wiedemann und Christoph von Brandenstein, Neustadt a. d. Aisch 2001 - Einzelarbeiten aus der Kirchengeschichte Bayerns, hg. v. Verein für bayerische Kirchengeschichte unter verantwortlicher Schriftleitung von Dr. Helmut Baier, 77.
Pf-Solothurn (Schmid, Kirchensätze)	Die Kirchensätze, die Stifts- und Pfarr-Geistlichkeit des Kantons Solothurn		Alexander Schmid, Die Kirchensätze, die Stifts- und Pfarr-Geistlichkeit des Kantons Solothurn, Solothurn 1857.
Pf-St. Gallen (Stückelberger)	Die evangelische Pfarrerschaft des Kantons St. Gallen		Die evangelische Pfarrerschaft des Kantons St. Gallen, seit dem Bestehen jeder reformierten Kirchgemeinde bis 1970 zusammengestellt und mit biographischen Notizen versehen von Hans Martin Stückelberger, St. Gallen 1971.
Pf-Thurgau (Sulzberger)	Biographisches Verzeichniß der Geistlichen aller evangelischen Gemeinden des Kantons Thurgau von der frühesten Zeit bis auf die Gegenwart		Huldreich Gustav Sulzberger, Biographisches Verzeichniß der Geistlichen aller evangelischen Gemeinden des Kantons Thurgau von der frühesten Zeit bis auf die Gegenwart, Frauenfeld 1863.
Pf-Zürich (Pfarrerbuch)	Zürcher Pfarrerbuch 1519-1952		Zürcher Pfarrerbuch 1519-1952, hg. v. Emanuel Dejung und Willy Wuhrmann, Zürich 1953.
Pfeilsticker	Neues württembergisches Dienerbuch		Neues württembergisches Dienerbuch, bearb. v. Walther Pfeilsticker, 3 Bde., Stuttgart 1957-1974.
Piccard	Wasserzeichen		Gerhard Piccard, Wasserzeichen, 17 Bde., Stuttgart 1961-1997 - Veröffentlichungen der Staatlichen Archivverwaltung Baden-Württemberg, Sonderreihe: Die Wasserzeichen Piccard im Hauptstaatsarchiv Stuttgart. Findbuch 1-17.
Polen	Forgotten Books (May 4, 2018)		Der Briefwechsel der Schweizer mit den Polen, hg. v. Theodor Wotschke, Leipzig 1908 - ARG. Texte und Untersuchungen. Ergänzungsband 3.
Pollet, Bucer	Martin Bucer. Etudes sur la correspondance, avec de nombreux textes inédits		Jacques V. Pollet, Martin Bucer. Etudes sur la correspondance, avec de nombreux textes inédits, 2 Bde., Paris 1958/1962.
Pollet, Relations	Martin Bucer. Etudes sur les relations de Bucer avec les Pays-Bas, l'Electorat de Cologne et l'Allemagne du Nord		Jacques V. Pollet, Martin Bucer. Etudes sur les relations de Bucer avec les Pays-Bas, l'Electorat de Cologne et l'Allemagne du Nord, 2 Bde., Leiden 1985 - Studies in Medieval and Reformation Thought 33f.
Potter	Henry VIII and Francis I. The Final Conflict, 1540-1547		David Potter, Henry VIII and Francis I. The Final Conflict, 1540-1547, Leiden/Boston 2011 - History of Warfare 66.
Pressel, Blarer (Pressel)	Ambrosius Blaurer's des schwäbischen Reformators Leben und Schriften		Theodor Pressel, Ambrosius Blaurer's des schwäbischen Reformators Leben und Schriften, Stuttgart 1861.
Prüser (Prüser, England)	England und die Schmalkaldener 1535-1540		Friedrich Prüser, England und die Schmalkaldener 1535-1540, Leipzig 1929 - QFRG 11.
QAGSP	Quellen und Abhandlungen zur Geschichte des Schweizerischen Protestantismus		Quellen und Abhandlungen zur Geschichte des Schweizerischen Protestantismus, Zürich 1946ff.
QASRG	Quellen und Abhandlungen zur Geschichte zur Schweizerischen Reformationsgeschichte		Quellen und Abhandlungen zur Geschichte zur Schweizerischen Reformationsgeschichte (= 2. Serie zu QSRG, Leipzig 1912ff.
QFRG	Quellen und Forschungen zur Reformationsgeschichte		Quellen und Forschungen zur Reformationsgeschichte, Gütersloh u.a. 1920ff.
QGT	Quellen zur Geschichte der Täufer		Quellen zur Geschichte der Täufer, Gütersloh 1938ff.
QGTS	Quellen zur Geschichte der Täufer in der Schweiz		Quellen zur Geschichte der Täufer in der Schweiz, hg. v. Leonhard von Muralt, Walter Schmid, Heinold Fast und Martin Haas. 4 Bde., Zürich 1952-2008.
QSG	Quellen zur Schweizer Geschichte		Quellen zur Schweizer Geschichte, hg. v. der Allgemeinen Geschichtsforschenden Gesellschaft der Schweiz, Bde. 1-25; NF 1ff Basel 1877ff.
QSRG	Quellen zur Schweizerischen Reformationsgeschichte		Quellen zur Schweizerischen Reformationsgeschichte, Basel 1901ff.
Quervain (de Quervain)	Kirchliche und soziale Zustände in Bern unmittelbar nach der Einführung der Reformation (1528-1536)		Theodor de Quervain, Kirchliche und soziale Zustände in Bern unmittelbar nach der Einführung der Reformation (1528-1536), Bern 1906.
RAC	Reallexikon für Antike und Christentum. Sachwörterbuch zur Auseinandersetzung des Christentums mit der antiken Welt		Reallexikon für Antike und Christentum. Sachwörterbuch zur Auseinandersetzung des Christentums mit der antiken Welt, hg. v. Theodor Klauser u.a., Stuttgart 1950ff.
RAG	Repertorium Academicum Germanicum. Die graduierten Gelehrten des Alten Reiches zwischen 1250 und 1550		Repertorium Academicum Germanicum. Die graduierten Gelehrten des Alten Reiches zwischen 1250 und 1550, Online-Datenbank erstellt unter der Leitung von Rainer Christoph Schwinges und Christian Hesse.
RBS	Reformierte Bekenntnisschriften		Reformierte Bekenntnisschriften, im Auftrag der Evangelischen Kirche in Deutschland hg. v. Heiner Faulenbach und Eberhard Busch, Neukirchen/Vluyn 2002ff.
RCG (Registres du Conseil)	Registres du Conseil de Genève		Registres du Conseil de Genève, hg. v. Emile Rivoire u.a., 13 Bde., Genf 1900-1940.
RCG-Calvin	Registres du Conseil de Genève à l'époque de Calvin		Registres du Conseil de Genève à l'époque de Calvin, hg. v. Paule Hochuli Dubuis u.a., Genf 2003ff - THR.
RE3 (RE)	Realenzyklopädie für protestantische Theologie und Kirche		Realenzyklopädie für protestantische Theologie und Kirche, 24 Bde., 3. Aufl., Leipzig 1896-1913.
RGG3 (RGG)	Die Religion in Geschichte und Gegenwart. Handwörterbuch für Theologie und Religionswissenschaft		Die Religion in Geschichte und Gegenwart. Handwörterbuch für Theologie und Religionswissenschaft, 3. Aufl., 6 Bde. und Registerbd., Tübingen 1957-1965.
RGG4	Die Religion in Geschichte und Gegenwart. Handwörterbuch für Theologie und Religionswissenschaft		Die Religion in Geschichte und Gegenwart. Handwörterbuch für Theologie und Religionswissenschaft, 4. Aufl., 9 Bde., Tübingen 1998-2007.
RGST	Reformationsgeschichte		Reformationsgeschichte, Studien und Texte, Münster 1906ff.
RSQ (RsQ I)	Repertorium schweizergeschichtlicher Quellen im Generallandesarchiv Karlsruhe		Repertorium schweizergeschichtlicher Quellen im Generallandesarchiv Karlsruhe, Abt. I: Konstanz - Reichenau, hg. v. Franziska Geiges-Heindl, Karl Mommsen, Martin Salzmann u.a, 4 Bde., Zürich 1981-1990, Abt. II: Säckingen, hg. v. Cathrine Bosshart, Suso Gartner, Martin Salzmann, Zürich 1986.
RTA-JR (RTA JR)	Deutsche Reichstagsakten		Deutsche Reichstagsakten, hg. durch die Historische Kommission bei der Bayerischen Akademie der Wissenschaften. Jüngere Reihe: Deutsche Reichstagsakten unter Kaiser Karl V., Gotha u.a. 1893ff.
Rabe, Reichsbund	Reichsbund und Interim. Die Verfassungs- und Reichspolitik Karls V. und der Reichstag von Augsburg 1547/1548		Horst Rabe, Reichsbund und Interim. Die Verfassungs- und Reichspolitik Karls V. und der Reichstag von Augsburg 1547/1548, Köln/Wien 1971.
Ramminger	Neulateinische Wortliste. Ein Wörterbuch des Lateinischen von Petrarca bis 1700		Johann Ramminger, Neulateinische Wortliste. Ein Wörterbuch des Lateinischen von Petrarca bis 1700 (http://ramminger.userweb.mwn.de).
Reinerth, Hentius	Martinus Hentius aus Kronstadt über den Lehrunterschied zwischen Wittenberg und der Schweiz in der Abendmahlsfrage im Jahr 1543		Karl Reinerth, Martinus Hentius aus Kronstadt über den Lehrunterschied zwischen Wittenberg und der Schweiz in der Abendmahlsfrage im Jahr 1543, in: ARG 64, 1963, 181-198.
Renaissance/Reformation (von Muralt, Renaissance und Reformation)	Renaissance und Reformation		Leonhard von Muralt, Renaissance und Reformation, in HSG I 389-570.
Renato, Opere	Opere, documenti e testimonianze, hg. von Antonio Rotondò		Camillo Renato, Opere, documenti e testimonianze, hg. von Antonio Rotondò, Florenz/Chicago 1968 - Corpus Reformatorum Italicorum.
Reske	Die Buchdrucker des 16. und 17. Jahrhunderts im deutschen Sprachgebiet		Christoph Reske, Die Buchdrucker des 16. und 17. Jahrhunderts im deutschen Sprachgebiet. Auf der Grundlage des gleichnamigen Werkes von Josef Benzing, Wiesbaden 2007 - Beiträge zum Buch- und Bibliothekswesen 51.
Rhenanus BW	Briefwechsel des Beatus Rhenanus		Briefwechsel des Beatus Rhenanus, gesammelt und hg. v. Adalbert Horawitz und Karl Hartfelder, Leipzig 1886 (Nachdruck: Nieuwkoop 1966).
Rockwell	Die Doppelehe des Landgrafen Philipp von Hessen		William Walker Rockwell, Die Doppelehe des Landgrafen Philipp von Hessen, Marburg 1904 (Nachdruck: Münster 1985).
Rommel	Philipp der Großmüthige, Landgraf von Hessen. Ein Beitrag zur genaueren Kunde der Reformation und des sechszehnten Jahrhunderts		Christoph von Rommel, Philipp der Großmüthige, Landgraf von Hessen. Ein Beitrag zur genaueren Kunde der Reformation und des sechszehnten Jahrhunderts, 3 Bde., Gießen 1830.
Rommel, Ulm	Die Reichsstadt Ulm in der Katastrophe des Schmalkaldischen Bundes		Franz Rommel, Die Reichsstadt Ulm in der Katastrophe des Schmalkaldischen Bundes, Stuttgart 1922.
Roth, Augsburg (Roth)	Augsburgs Reformationsgeschichte		Friedrich Roth, Augsburgs Reformationsgeschichte, 4 Bde., München 1901-1911 (Nachdruck: München 1974).
Roth, Siebenbürgen	Die Reformation in Siebenbürgen. Ihr Verhältnis zu Wittenberg und der Schweiz.		Erich Roth, Die Reformation in Siebenbürgen. Ihr Verhältnis zu Wittenberg und der Schweiz. 1. Teil: Der Durchbruch, Köln/Graz 1962 - Siebenbürgisches Archiv. 3. Folge 2.
Rotondò, Anticristo	Anticristo e chiesa Romana. Diffusione e metamorfosi d'un libello antiromano del Cinquecento		Antonio Rotondò, Anticristo e chiesa Romana. Diffusione e metamorfosi d'un libello antiromano del Cinquecento, in: Forme e destinazione del messaggio religioso. Aspetti della propaganda religiosa nel Cinquecento, hg. v. Antonio Rotondò, Firenze 1991 - Studi e testi per la storia religiosa del Cinquecento 2, S. 19-164.
Rott, Bullinger und Straßburg	Die Überlieferung des Briefwechsels von Bullinger und den Zürchern mit Martin Bucer und den Straßburgern		Jean Rott, Die Überlieferung des Briefwechsels von Bullinger und den Zürchern mit Martin Bucer und den Straßburgern, in HBGesA II 257-286.
Rott, Liste (Rott, Corr. de Bucer, Liste)	Correspondance de Martin Bucer. Liste alphabétique des correspondants		Jean Rott, Correspondance de Martin Bucer. Liste alphabétique des correspondants, Strasbourg 1977 - Association des Publications de la Faculté de Théologie Protestante de l'Université des Sciences Humaines de Strasbourg, Bulletin nr. 1.
Rott, Représentation (Rott, Représentation Diplomatique)	Histoire de la Représentation Diplomatique de la France auprès des Cantons Suisses, de leurs Alliés et de leurs Confédérés		Edouard Rott, Histoire de la Représentation Diplomatique de la France auprès des Cantons Suisses, de leurs Alliés et de leurs Confédérés, Bd. I: 1430-1559, Bern 1900.
Rozet/Lembey	L'Invasion de la France et le Siège de Saint-Dizier par Charles-Quint en 1544 d'après les Dépêches italiennes de Francesco d'Este, de Hieronymo Feruffino, de Camillo Capilupo et de Bernardo Navager		Albin Rozet und J.-F. Lembey, L'Invasion de la France et le Siège de Saint-Dizier par Charles-Quint en 1544 d'après les Dépêches italiennes de Francesco d'Este, de Hieronymo Feruffino, de Camillo Capilupo et de Bernardo Navager, Paris 1910.
Rublack, Konstanz	Die Einführung der Reformation in Konstanz von den Anfängen bis zum Abschluß 1531		Hans-Christoph Rublack, Die Einführung der Reformation in Konstanz von den Anfängen bis zum Abschluß 1531, Gütersloh/Karlsruhe 1971 - QFRG 40.
Rublack, Nördlingen	Eine bürgerliche Reformation: Nördlingen		Hans-Christoph Rublack, Eine bürgerliche Reformation: Nördlingen, Heidelberg 1982 - QFRG 51.
Rudolf	Heinrich Bullingers Berufung nach Basel		F[riedrich] R[udolf], Heinrich Bullingers Berufung nach Basel, in: Neue Zürcher Zeitung, 18. August 1945, Nr. 1252.
Rudolf, Aussöhnungsversuch	Ein Aussöhnungsversuch zwischen Zürich und Bern nach dem Briefwechsel Bullinger-Myconius 1533-1534		Friedrich Rudolf, Ein Aussöhnungsversuch zwischen Zürich und Bern nach dem Briefwechsel Bullinger-Myconius 1533-1534, in: Zwa VII 504-521.
Rudolf, Studenten	Der Briefwechsel zwischen Heinrich Bullinger und vier Zürcher Studenten in der Fremde, 1540/42		Friedrich Rudolf, Der Briefwechsel zwischen Heinrich Bullinger und vier Zürcher Studenten in der Fremde, 1540/42, in: ZTB 1943, NF 63, S. 51-66.
Rudolphi	Die Buchdrucker-Familie Froschauer in Zürich 1521-1595.		Die Buchdrucker-Familie Froschauer in Zürich 1521-1595. Verzeichniss der aus ihrer Offizin hervorgegangenen Druckwerke. Zusammengestellt und geordnet von E. Camillo Rudolphi, Zürich 1869 (Nachdruck: Nieuwkoop 1963).
Ruffini, Stancaro	Francesco Ruffini		Francesco Ruffini, Francesco Stancaro. Contributo alla storia della Riforma in Italia, in: ders., Studi sui riformatori italiani, hg. v. Arnaldo Bertola u.a, Turin 1955, S. 165-406.
Röhrich	Lexikon der sprichwörtlichen Redensarten		Lutz Röhrich, Lexikon der sprichwörtlichen Redensarten, 5 Bde., 3. Aufl., Freiburg u.a. 1995 - Herder Spektrum 4400.
Rüeger, Chronik (Rüeger)	Chronik der Stadt und Landschaft Schaffhausen		Johann Jakob Rüeger, Chronik der Stadt und Landschaft Schaffhausen, hg. v. Historisch-antiquarischen Verein des Kantons Schaffhausen, 2 Bde., Schaffhausen 1884/1892; Register, bearb. v. Georg Wanner, Schaffhausen 1910.
Rüetschi, Bildgedichte	Kurt Jakob Rüetschi Bildgedichte Rudolf Gwalthers		Kurt Jakob Rüetschi Bildgedichte Rudolf Gwalthers. Eine Quelle für Nachweis und Datierung von Zürcher Kunstwerken, in: Von Cyprian zur Walzenprägung. Streiflichter auf Zürcher Geist und Kultur der Bullingerzeit, Prof. Dr. Rudolf Schnyder zum 70. Geburtstag, hg. v. Hans Ulrich Bächtold, Zug 2001, S. 145-229.
Rüetschi, Gwalthers BW	Verzeichnis zu Rudolf Gwalther Vater (1519-1586) und Sohn (1552-1577)		Kurt Jakob Rüetschi, Verzeichnis zu Rudolf Gwalther Vater (1519-1586) und Sohn (1552-1577), Bd. I/1: Einleitung - Briefwechsel - Verzeichnis; Bd. I/2: Register, Baden-Baden 2019 - Bibliotheca Bibliographica Aureliana 253/4.
S	Huldreich Zwinglis Werke		Huldreich Zwinglis Werke. Ersste vollständige Ausgabe durch Melchior Schuler und Joh. Schulthess, 8 Bde., und 1 Suppl. bd., Zürich 1828-1842 und 1861.
SBAG	Schweizer Beiträge zur Allgemeinen Geschichte		Schweizer Beiträge zur Allgemeinen Geschichte, im Auftrag der Allgemeinen geschichtforschenden Gesellschaft der Schweiz, Aarau 1943ff.
SBB	Sammlung Bernerischer Biographien		Sammlung Bernerischer Biographien, hg. v. Historischen Verein des Kantons Bern, 5 Bde., Bern 1884-1902.
SC (SChr)	Sources chrétiennes		Sources chrétiennes, Lyon und später Paris, 1942ff.
SChr	Sources Chrétiennes		Sources Chrétiennes, Paris 1941ff.
SI	Schweizerisches Idiotikon. Wörterbuch der schweizerdeutschen Sprache		Schweizerisches Idiotikon. Wörterbuch der schweizerdeutschen Sprache, Frauenfeld 1881ff (http://www.idiotikon.ch/).
SKL	Schweizerisches Künstlerlexikon		Schweizerisches Künstlerlexikon, hg. mit Unterstützung des Bundes und kunstfreundlicher Privater v. Schweizerischen Kunstverein, redigiert unter Mitwirkung von Fachgenossen von Carl Brun, 4 Bde, Frauenfeld 1905-1917.
SKRG	Schriften zur Kirchen- und Rechtsgeschichte		Schriften zur Kirchen- und Rechtsgeschichte. Darstellungen und Quellen, hg. v. Ekkehart Fabian, Tübingen u.a. 1956-1985.
SMRT	Studies in Medieval and Renaissance Thought		Studies in Medieval and Renaissance Thought, Leiden 1966-2004.
SSRQ-Bern (SSRQ Bern)	Die Rechtsquellen des Kantons Bern		Die Rechtsquellen des Kantons Bern, Aarau 1939ff - Sammlung Schweizerischer Rechtsquellen, II. Abt.
SSRQ-Thurgau	Die Rechtsquellen des Thurgau Bern		Die Rechtsquellen des Thurgau Bern, Basel 2017ff - Sammlung Schweizerischer Rechtsquellen, XVII. Abt.
STC2	A Short-Title Catalogue of Books Printed in England, Scotland, Ireland and of English Books Printed Abroad, 1475-1640		A Short-Title Catalogue of Books Printed in England, Scotland, Ireland and of English Books Printed Abroad, 1475 - 1640, hg. v. Alfred W. Pollard und Gilbert R. Redgrave, 2. revidierte und erweiterte Ausgabe von William A. Jackson, Frederic S. Ferguson und Katharina F. Panzer, 3 Bde., 1976-1991.
SVRG	Schriften des Vereins für Reformationsgeschichte		Schriften des Vereins für Reformationsgeschichte, Güthersloh u.a. 1883ff.
Salat	Hans Salat, ein Schweizerischer Chronit und Dichter aus der ersten Hälfte des XVI. Jahrhunderts. Sein Leben und seine Schriften		Hans Salat, ein Schweizerischer Chronit und Dichter aus der ersten Hälfte des XVI. Jahrhunderts. Sein Leben und seine Schriften, hg. v. Jacob Baechtold, Basel 1876.
Schaff	The Creeds of Christendom with a History and Critical Notes		The Creeds of Christendom with a History and Critical Notes, hg. v. Philip Schaff, überarbeitet von David S. Schaff, 3 Bde., 6. Aufl., New York 1931 [Nachdruck: Grand Rapids, Michigan 1983].
Scheible, Wittenberg	Melanchthon rettet die Universität Wittenberg		Heinz Scheible, Melanchthon rettet die Universität Wittenberg, in: ders., Aufsätze zu Melanchthon, Tübingen 2010, S. 253-276.
Schertlin, Leben	Leben und Thaten des weiland wohledlen und gestrengen Herrn Sebastian Schertlin von Burtenbach		Leben und Thaten des weiland wohledlen und gestrengen Herrn Sebastian Schertlin von Burtenbach, durch ihn selbst deutsch beschrieben, hg. von Ottmar F. H. Schönhuth, Münster 1858.
Scheurer, Haller	Nachricht von dem Leben und Verrichtungen Joh. Hallers, des Helffers zu schweitz, Zweysimmen und Thun, Schullehrers zu Interlacken, Pfarrers zu Schertzligen, Anseltingen und Bühlach, wie auch Joh. Hallers Des Sohns, Pfarrers zu Augspurg und Bern, auch Decans allda		Samuel Scheurer, Nachricht von dem Leben und Verrichtungen Joh. Hallers, des Helffers zu schweitz, Zweysimmen und Thun, Schullehrers zu Interlacken, Pfarrers zu Schertzligen, Anseltingen und Bühlach, wie auch Joh. Hallers Des Sohns, Pfarrers zu Augspurg und Bern, auch Decans allda, in: Bernerisches Mausoleum, 6. Stück, Bern 1743, S. 395-548.
Schl.	Bibliographie zur deutschen Geschichte im Zeitalter der Glaubensspaltung 1517-1585		Karl Schottenloher, Bibliographie zur deutschen Geschichte im Zeitalter der Glaubensspaltung 1517-1585, 6 Bde., Stuttgart 1956-1958
Schlüter (Schlüter, Streitschriften)	Flug- und Streitschriften zur "Kölner Reformation"		Theodor C. Schlüter, Flug- und Streitschriften zur "Kölner Reformation", Wiesbaden 2005 - Buchwissenschaftliche Beiträge aus dem Deutschen Bucharchiv München 73.
Schlütter-Schindler	Der Schmalkaldische Bund und das Problem der causa religionis		Gabriele Schlütter-Schindler, Der Schmalkaldische Bund und das Problem der causa religionis, Frankfurt 1986 - Europäische Hochschulschriften. III. Reihe 283.
Schmidlin, Solothurn (Schmidlin)	Solothurns Glaubenskampf und Reformation im 16. Jahrhundert		Ludwig Rochus Schmidlin, Solothurns Glaubenskampf und Reformation im 16. Jahrhundert, Solothurn 1904.
Schmidt, Städtetag	Der Städtetag in der Reichsverfassung. Eine Untersuchung zur korporativen Politik der Freien und Reichsstädte in der ersten Hälfte des 16. Jahrhunderts		Georg Schmidt, Der Städtetag in der Reichsverfassung. Eine Untersuchung zur korporativen Politik der Freien und Reichsstädte in der ersten Hälfte des 16. Jahrhunderts, Stuttgart 1984 - Veröffentlichungen des Instituts für Europäische Geschichte Mainz, Abt. Universalgeschichte 113; Beiträge zur Sozial- und Verfassungsgeschichte des Alten Reiches 5.
Schnyder, Ratslisten	Die Zürcher Ratslisten 1225 bis 1798		Die Zürcher Ratslisten 1225 bis 1798, hg. v. Staatsarchiv des Kantons Zürich und bearb. v. Werner Schnyder, Zürich 1962.
Schott-Volm1 (Schott-Volm	Repertorium der Policeyordnungen der Frühen Neuzeit	7	Claudia Schott-Volm, Repertorium der Policeyordnungen der Frühen Neuzeit, hg. v. Karl Härter und Michael Stolleis, Bd. 7/1: Orte der Schweizer Eidgenossenschaft: Bern, Frankfurt a. M. 2006 - Studien zur europäischen Rechtsgeschichte 204/1.
Schott-Volm2	Repertorium der Policeyordnungen der Frühen Neuzeit		Claudia Schott-Volm, Repertorium der Policeyordnungen der Frühen Neuzeit, hg. v. Karl Härter und Michael Stolleis, Bd. 7/2: Orte der Schweizer Eidgenossenschaft: Zürich, Frankfurt a. M. 2006 - Studien zur europäischen Rechtsgeschichte 204/2.
Schulte, Hansestädte	Niederdeutsche Hansestädte in der Spätzeit Kaiser Karls V. Bündische Städtepolitik zwischen Schmalkaldischem Krieg und Passauer Vertrag. Städtische Tagfahrten und Zusammenkünfte in den Jahren 1546-1552		Günter Schulte, Niederdeutsche Hansestädte in der Spätzeit Kaiser Karls V. Bündische Städtepolitik zwischen Schmalkaldischem Krieg und Passauer Vertrag. Städtische Tagfahrten und Zusammenkünfte in den Jahren 1546-1552, Diss. Münster 1987.
Schultheß-Rechberg	Heinrich Bullinger, der Nachfolger Zwinglis		Gustav von Schultheß-Rechberg, Heinrich Bullinger, der Nachfolger Zwinglis, Halle a.d. Saale / Zürich 1904. - SVRG XXII/1.
Schultz, Schwenckfeld	Caspar Schwenckfeld von Ossig (1489-1561)		Selina Gerhard Schultz, Caspar Schwenckfeld von Ossig (1489-1561), 4. Aufl., Pennsburg 1977.
Schwarz, Calvin (Schwarz, Calvins Lebenswerk)	Johannes Calvins Lebenswerk in seinen Briefen		Johannes Calvins Lebenswerk in seinen Briefen, eine Auswahl von Briefen Calvins in deutscher Übersetzung von Rudolf Schwarz, 2. Aufl., 3 Bde., Neukirchen-Vluyn 1961/1962.
Schüz, Donaufeldzug	Der Donaufeldzug Karls V. im Jahre 1546		Alfred Schüz, Der Donaufeldzug Karls V. im Jahre 1546, Tübingen 1930.
Seckendorf	Commentarius historicus et apologeticus de Lutheranismo sive de Reformatione religionis ductu D. Martini Lutheri in magna Germaniae parte aliisque regionibus et speciatim in Saxonia recepta et stabilita ...		Veit Ludwig von Seckendorf, Commentarius historicus et apologeticus de Lutheranismo sive de Reformatione religionis ductu D. Martini Lutheri in magna Germaniae parte aliisque regionibus et speciatim in Saxonia recepta et stabilita ..., Frankfurt/Leipzig 1692.
Seeliger	Zittauer Freunde der Züricher Reformatoren und der Böhmischen Brüder		Ernst Alwin Seeliger, Zittauer Freunde der Züricher Reformatoren und der Böhmischen Brüder, in: Zittauer Geschichtsblätter (Beilage zu den Zittauer Nachrichten) IX/10, Zittau 1932, S. 37-44.
Seidel	Frankreich und die deutschen Protestanten. Die Bemühungen um eine religiöse Konkordie und die französische Bündnispolitik in den Jahren 1534/35		Karl Josef Seidel, Frankreich und die deutschen Protestanten. Die Bemühungen um eine religiöse Konkordie und die französische Bündnispolitik in den Jahren 1534/35, Münster 1970 - Reformationsgeschichtliche Studien und Texte 102. RGST 102
Senn (Senn, Wick)	Johann Jakob Wick (1522-1588) und seine Sammlung von Nachrichten zur Zeitgeschichte		Matthias Ludwig Senn, Johann Jakob Wick (1522-1588) und seine Sammlung von Nachrichten zur Zeitgeschichte, Diss. phil. I, Zürich 1973 - Mitteilungen der Antiquarischen Gesellschaft in Zürich 46/2, Zürich 1974.
Sigel	Das evangelische Württemberg		Christian Sigel, Das evangelische Württemberg, II. Hauptteil: Generalmagisterbuch. Mitteilungen aus dem Leben der evangelischen Geistlichen von der Reformation bis auf die Gegenwart. Ein Nachschlagewerk in alphabetischer Ordnung. (Typoskript im Landeskirchlichen Archiv Stuttgart).
Simler	Sammlung alter und neuer Urkunden zur Beleuchtung der Kirchen-Geschichte		Johann Jacob Simler, Sammlung alter und neuer Urkunden zur Beleuchtung der Kirchen-Geschichte, vornehmlich des Schweizerlandes, 2 Bde., Zürich 1767.
Simmet	Die Versöhnung der freien Reichsstadt Augsburg mit Kaiser Karl V		Ludwig Simmet, Die Versöhnung der freien Reichsstadt Augsburg mit Kaiser Karl V. 1547, Augsburg [1888] - Jahresbericht über die Königliche Kreis-Realschule in Augsburg.
Sinapius (Flood/Shaw)	Johannes Sinapius (1505-1560). Hellenist and Physician in Germany and Italy		John L. Flood und David J. Shaw, Johannes Sinapius (1505-1560). Hellenist and Physician in Germany and Italy, Genf 1997 - THR 311.
Sleidan BW	Sleidans Briefwechsel		Sleidans Briefwechsel, hg. v. Hermann Baumgarten, Straßburg 1881.
Solothurn (Amiet/Sigrist)	Solothurnische Geschichte		Bruno Amiet und Hans Sigrist, Solothurnische Geschichte, Bd. 2: Stadt und Kanton Solothurn von der Reformation bis zum Höhepunkt des patrizischen Regimes, Solothurn 1976.
Sommervogel	Bibliothèque de la Compagnie de Jésus		Bibliothèque de la Compagnie de Jésus. Première partie: Bibliographie, bearb. v. Carlos Sommervogel, Augustin und Aloys de Backer, Auguste Carayon und Ernest-Marie Rivière, 11 Bde., Brüssel/Paris 1890-1930 (Bd. XI beinhaltet Ergänzungen).
Spahn	Johannes Cochläus. Ein Lebensbild aus der Zeit der Kirchenspaltung		Martin Spahn, Johannes Cochläus. Ein Lebensbild aus der Zeit der Kirchenspaltung, Berlin 1898 (Nachdruck: Nieuwkoop 1964).
Spehr	Luther und das Konzil. Zur Entwicklung eines zentralen Themas in der Reformationszeit		Christopher Spehr, Luther und das Konzil. Zur Entwicklung eines zentralen Themas in der Reformationszeit, Tübingen 2010 - Beiträge zur historischen Theologie 153.
StDTh	Studien zur Dogmengeschichte und systematischen Theologie		Studien zur Dogmengeschichte und systematischen Theologie, Zürich 1952ff.
Staedtke	Die Theologie des jungen Bullinger		Joachim Staedkte, Die Theologie des jungen Bullinger, Zürich 1962 – Studien zur Dogmengeschichte und systematischen Theologie 16. StDTh XVI
Staedtke, Zug	Heinrich Bullingers Bemühungen um die Reformation im Kanton Zug		Joachim Staedtke, Heinrich Bullingers Bemühungen um die Reformation im Kanton Zug, in: Zwa X 24-47.
Staehelin	Das theologische Lebenswerk Oekolampads		Ernst Staehelin, Das theologische Lebenswerk Oekolampads, Leipzig 1939. - QFRG XXI.
Staehelin, Ehescheidung	Die Einführung der Ehescheidung in Basel zur Zeit der Reformation		Adrian Staehlin, Die Einführung der Ehescheidung in Basel zur Zeit der Reformation, Basel 1957 - Basler Studien zur Rechtswissenschaft 45.
Staerkle, St. Gallen (Staerkle)	Beiträge zur spätmittelalterlichen Bildungsgeschichte St. Gallens		Paul Staerkle, Beiträge zur spätmittelalterlichen Bildungsgeschichte St. Gallens, St. Gallen 1939 - MVG 40.
Stanislaus Ostrorog: Ein Schutzherr der grosspolnischen evangelischen Kirche	Zeitschrift der Historischen Gesellschaft für die Provinz Posen		Prümers, Rodgero (1907) "Stanislaus Ostrorog: Ein Schutzherr der grosspolnischen evangelischen Kirche", Posen 1907. 132 S.
Steinmann (Steinmann, Oporinus)	Johannes Oporinus. Ein Basler Buchdrucker um die Mitte des 16. Jahrhunderts		Martin Steinmann, Johannes Oporinus. Ein Basler Buchdrucker um die Mitte des 16. Jahrhunderts, Basel 1967 - Basler Beiträge zur Geschichtswissenschaft 105.
Storkebaum, Oldenburg	Graf Christoph von Oldenburg (1504-1566). Ein Lebensbild im Rahmen der Reformationsgeschichte		Werner Storkebaum, Graf Christoph von Oldenburg (1504-1566). Ein Lebensbild im Rahmen der Reformationsgeschichte, Oldenburg 1959.
Stotz	Handbuch zur lateinischen Sprache des Mittelalters		Peter Stotz, Handbuch zur lateinischen Sprache des Mittelalters, Bd. 1: Einleitung, Lexikologische Praxis, Wörter und Sachen, Lehnwortgut, München 2002; Bd. 2: Bedeutungswandel und Wortbildung, München 2000; Bd. 3: Lautlehre, München 1996; Bd. 4: Formenlehre, Syntax und Stilistik, München 1998; Bd. 5: Bibliographie, Quellenübersicht und Register, München 2004.
Straßer (Strasser)	Capitos Beziehungen zu Bern		Otto Erich Straßer, Capitos Beziehungen zu Bern, Leipzig 1928 - Quellen und Abhandlungen zur Schweizerischen Reformationsgeschichte 4 und 7. QASRG IV
Strieder	Grundlage zu einer hessischen Gelehrten- und Schriftsteller-Geschichte seit der Reformation bis auf gegenwärtige Zeiten		Friedrich Wilhelm Strieder, Grundlage zu einer hessischen Gelehrten- und Schriftsteller-Geschichte seit der Reformation bis auf gegenwärtige Zeiten, 21 Bde., Göttingen und (ab Bd. 9) Kassel 1781-1868.
Strohm, A Lasco	Johannes a Lasco (1499-1560). Polnischer Baron, Humanist und europäischer Reformator		Johannes a Lasco (1499-1560). Polnischer Baron, Humanist und europäischer Reformator, hg. v. Christoph Strohm, Tübingen 2000 - Spätmittelalter und Reformation, Neue Reihe 14.
Stucki	Bürgermeister Hans Rudolf Lavater 1492-1557. Ein Politiker der Reformationszeit		Heinzpeter Stucki, Bürgermeister Hans Rudolf Lavater 1492-1557. Ein Politiker der Reformationszeit, Zürich 1973 - ZBRG 3.
Studer Immenhauser	Verwaltung zwischen Innovation und Tradition. Die Stadt Bern und ihr Untertanengebiet 1250-1550		Barbara Katharina Studer Immenhauser, Verwaltung zwischen Innovation und Tradition. Die Stadt Bern und ihr Untertanengebiet 1250-1550, Ostfildern 2006 - Mittelalter-Forschungen 19.
Stumpf, Abendmahl (Stumpf, Abendmahlsstreit)	Beschreibung des Abendmahlsstreites von Johann Stumpf		Beschreibung des Abendmahlsstreites von Johann Stumpf, auf Grund einer unbekannt gebliebenen Handschrift ediert von Fritz Büsser, Zürich 1960 - Veröffentlichungen der Rosa Ritter-Zweifel-Stiftung, Historische Reihe.
Stumpf, Chronik (Stumpf, Reformationschronik)	Johannes Stumpfs Schweizer- und Reformationschronik		Johannes Stumpfs Schweizer- und Reformationschronik, hg. v. Ernst Gagliardi, Hans Müller und Fritz Büsser, 2 Bde., Basel 1952/1955 - Quellen zur Schweizer Geschichte, Neue Folge, Abt. 1: Chroniken, 5f.
Stähelin, Calvin (Stähelin)	Johannes Calvin. Leben und ausgewählte Schriften		Ernst Stähelin, Johannes Calvin. Leben und ausgewählte Schriften, Elberfeld 1863 - Leben und ausgewählte Schriften der Väter und Begründer der reformirten Kirche 4/1.
Stälin	Aufenthaltsorte Kaiser Karls V.		Christoph Friedrich von Stälin, Aufenthaltsorte Kaiser Karls V., in: Forschungen zur Deutschen Geschichte 5, 1865, S. 563-587.
Sulser	Der Stadtschreiber Peter Cyro und die Bernische Kanzlei zur Zeit der Reformation		Mathias Sulser, Der Stadtschreiber Peter Cyro und die Bernische Kanzlei zur Zeit der Reformation, Bern 1922.
THR	Travaux d'Humanisme et Renaissance		Travaux d'Humanisme et Renaissance, Genf 1950ff.
TPMA	Thesaurus proverbiorum medii aevi = Lexikon der Sprichwörter des romanisch-germanischen Mittelalters		Thesaurus proverbiorum medii aevi = Lexikon der Sprichwörter des romanisch-germanischen Mittelalters, hg. v. Kuratorium Singer der Schweizerischen Akademie der Geistes- und Sozialwissenschaften, 13 Bde. und Quellenverzeichnis, Bern 1995-2002.
TRE	Theologische Realenzyklopädie		Theologische Realenzyklopädie, hg. v. Gerhard Krause und Gerhard Müller, 36 Bde., Berlin/New York 1977-2004.
Tardent	Niklaus Manuel als Staatsmann		Jean-Paul Tardent, Niklaus Manuel als Staatsmann, Bern 1967. - AHVB 51, 1967.
Tedeschi, Socinus	Italian Reformation Studies in honor of Laelius Socinus		Italian Reformation Studies in honor of Laelius Socinus, hg. v. John Tedeschi, Florenz 1965.
Tedeschi/Lattis	The Italian Reformation of the Sixteenth Century and the Diffusion of Renaissance Culture: A Bibliography of the Secondary Literature (ca. 1750-1997)		John Tedeschi und James M. Lattis, The Italian Reformation of the Sixteenth Century and the Diffusion of Renaissance Culture: A Bibliography of the Secondary Literature (ca. 1750-1997), Ferrara und Modena 2000.
Territorien des Reichs	Die Territorien des Reichs im Zeitalter der Reformation und Konfessionalisierung. Land und Konfession 1500-1650		Die Territorien des Reichs im Zeitalter der Reformation und Konfessionalisierung. Land und Konfession 1500-1650, hg. von Anton Schindling und Walter Ziegler, 7 Bde., Münster 1989-1997 - Katholisches Leben und Kirchenreform im Zeitalter der Glaubensspaltung. Vereinsschriften der Gesellschaft zur Herausgabe des Corpus Catholicorum, hg. von Klaus Ganzer, 49-53; 56-57.
ThLG	Thesaurus Linguae Graecae		Henricus Stephanus, Thesaurus Linguae Graecae, 8 Bde., Paris 1831-1865
ThLL	Thesaurus linguae Latinae		Thesaurus linguae Latinae, Berlin und (ab 1991) Stuttgart, 1900ff.
ThZ	Theologische Zeitschrift		Theologische Zeitschrift, hg. v. der theologischen Fakultät der Universität Basel, Basel 1945ff.
The Autograph Souvenir	A Collection of Autograph Letters, Interesting Documents&Executed in Facsimile	1	F.G. Netherclift, The Autograph Souvenir, London 1863
Theologenbriefwechsel im Südwesten des Reichs in der Frühen Neuzeit (1550-1620).	Theologenbriefwechsel im Südwesten des Reichs in der Frühen Neuzeit (1550-1620).	96	Theologenbriefwechsel im Südwesten des Reichs in der Frühen Neuzeit (1550-1620).
Thieme-Becker	Allgemeines Lexikon der bildenden Künstler von der Antike bis zur Gegenwart		Allgemeines Lexikon der bildenden Künstler von der Antike bis zur Gegenwart, begründet von Ulrich Thieme und Felix Becker, hg. v. Hans Vollmer, 36 Bde, Leipzig 1907-1947.
Thomas, S. Th	S. Thomae Aquinatis Summa Theologiae, cura et studdio Petri Caramello		S. Thomae Aquinatis Summa Theologiae, cura et studdio Petri Caramello, 3 Bde., Turin-Rom 1952-1965.
Thommen	Geschichte der Universität Basel 1532-1632		Rudolf Thommen, Geschichte der Universität Basel 1532-1632, Basel 1889.
Tillier	Geschichte des eidgenössischen Freistaates Bern von seinem Ursprunge bis zu seinem Untergange im Jahre 1798		Anton von Tillier, Geschichte des eidgenössischen Freistaates Bern von seinem Ursprunge bis zu seinem Untergange im Jahre 1798, 5 Bde. und Sachregisterband, Bern 1838-1840.
Toggenburger Chronik	Toggenburger Chronik. Urkundliche Geschichte sämmtlicher katholischer und evangelischer Kirchgemeinden der Landschaft Toggenburg		Toggenburger Chronik. Urkundliche Geschichte sämmtlicher katholischer und evangelischer Kirchgemeinden der Landschaft Toggenburg. Aus archivischen Quellen gesammelt und zusammengestellt von Aloïs Rüdliger und Huldreich Gustav Sulzberger, bearb. von Franz Rothenflue, Bütschwil 1887.
Traut	Kurfürst Joachim II. von Brandenburg und der Türkenfeldzug vom Jahre 1542		Hermann Heinrich Traut, Kurfürst Joachim II. von Brandenburg und der Türkenfeldzug vom Jahre 1542, Gummersbach 1892.
Trubar	Slavisticna Revija	3	Mirko, Rupel (1950) "H Korespondenci Trubar - Bullinger", Slavistična Revija 3 (1-2):149-56, Ljubljana, https://srl.si/ojs/srl/article/view/1950-1-2-0-18.
Turetschek	Die Türkenpolitik Ferdinands I. von 1529-1532	10	Christine Turetschek, Die Türkenpolitik Ferdinands I. von 1529-1532, Wien 1968. - Dissertationen der Universität Wien, Bd. 10.
UBZug	Urkundenbuch von Stadt und Amt Zug. Vom Eintritt in den Bund bis zum Ausgang des Mittelalters 1352-1528		Urkundenbuch von Stadt und Amt Zug. Vom Eintritt in den Bund bis zum Ausgang des Mittelalters 1352-1528, bearb. Und hg. v. E[ugen] Gruber, A[lbert] Iten, E[rst] Zumbach, 2 Bde., Zug 1952/1964.
USTC	Universal Short Title Catalogue		Universal Short Title Catalogue (http://ustc.ac.uk).
Une grande figure de réformateur, Henri Bullinger	Semeur vaudois. Journal de l’église nationale	LXXVIe	Meylan, Henri (1954) "Une grande figure de réformateur, Henri Bullinger", Semeur vaudois. Journal de l’église nationale.
Unveröffentlichte Werke der Kappeler Zeit	Heinrich Bullinger, Theologische Schriften	2	Heinrich Bullinger, Theologische Schriften, Bd. 2: Unveröffentlichte Werke der Kappeler Zeit; Theologica, bearb. von H.-G. vom Berg, B. Schneider und E. Zsindely, Zürich 1991, 19-31.
VD16 (VD 16)	Verzeichnis der im deutschen Sprachbereich erschienenen Drucke des XVI. Jahrhunderts		Verzeichnis der im deutschen Sprachbereich erschienenen Drucke des XVI. Jahrhunderts: VD 16, hg. v. der Bayerischen Staatsbibliothek in München in Verbindung mit der Herzog-August-Bibliothek in Wolfenbüttel, 25 Bde., Stuttgart 1982-2000 (www.vd16.de).
VL16	Frühe Neuzeit in Deutschland, 1520-1620. Verfasserlexikon		Frühe Neuzeit in Deutschland, 1520-1620. Verfasserlexikon, hg. v. Wilhelm Kühlmann, Jan-Dirk Müller, Michael Schilling, Johann Anselm Steiger und Friedrich Vollhardt, Berlin/New York 2011ff.
VLHum	Deutscher Humanismus		Deutscher Humanismus, 1480-1520. Verfasserlexikon, hg. v. Franz Josepf Worstbrock, 3 Bde., Berlin/New York 2008-2015.
Vadian BW	Die Vadianische Briefsammlung der Stadtbibliothek St. Gallen		Die Vadianische Briefsammlung der Stadtbibliothek St. Gallen, hg. v. Emil Arbenz und Hermann Wartmann, 7 Bde., St. Gallen 1890-1913 - MVG 24-30a.
Vadian BW V	Vadianische Briefsammlung V. 1531-1540	V	Die Vadianische Briefsammlung der Stadtbibliothek St. Gallen, hg. v. Emil Arbenz und Hermann Wartmann, 7 Bde., St. Gallen 1890-1913 - MVG 24-30a.
Vadian BW VI	Vadianische Briefsammlung VI. 1541-1551	6	Die Vadianische Briefsammlung der Stadtbibliothek St. Gallen, hg. v. Emil Arbenz und Hermann Wartmann, 7 Bde., St. Gallen 1890-1913 - MVG 24-30a.
Vadian BW VII	Vadianische Briefsammlung VII (Ergänzungsband)	7	Die Vadianische Briefsammlung der Stadtbibliothek St. Gallen, hg. v. Emil Arbenz und Hermann Wartmann, 7 Bde., St. Gallen 1890-1913 - MVG 24-30a.
Vadian BW VII	Vadianische Briefsammlung VII (Ergänzungsband)	7	Die Vadianische Briefsammlung der Stadtbibliothek St. Gallen, hg. v. Emil Arbenz und Hermann Wartmann, 7 Bde., St. Gallen 1890-1913 - MVG 24-30a.
Vadian DHS	Deutsche historische Schriften		Joachim v. Watt (Vadian), Deutsche historische Schriften, hg. v. Ernst Götzinger, 3 Bde., St. Gallen 1875-1879.
Vadian Diarium	Diarium		Joachim von Watt (Vadian), Diarium, hg v. Ernst Götzinger, in: Vadian DHS 227-528.
Vadian Grosse Chronik	Die Grössere Chronik der Äbte. Abtei und Stadt St. Gallen im Hoch- und Spätmittelalter (1199-1491) aus reformatorischer Sicht		Joachim v. Watt (Vadian), Die Grössere Chronik der Äbte. Abtei und Stadt St. Gallen im Hoch- und Spätmittelalter (1199-1491) aus reformatorischer Sicht, hg. v. Bernhard Stettler, 2 Bde., Zürich 2010.
Vanautgaerden	Erasme typographe. Humanisme et imprimerie au début du XVI		Alexandre Vanautgaerden, Erasme typographe. Humanisme et imprimerie au début du XVI
Varrentrapp (Varrentrapp, Reformationsversuch)	Hermann von Wied und sein Reformationsversuch in Köln. Ein Beitrag zur deutschen Reformationsgeschichte		Conrad Varrentrapp, Hermann von Wied und sein Reformationsversuch in Köln. Ein Beitrag zur deutschen Reformationsgeschichte, Leipzig 1878.
Vasella, St. Nicolai	Die Geschichte des Predigerklosters St. Nicolai in Chur		Oskar Vasella, Die Geschichte des Predigerklosters St. Nicolai in Chur, Diss. Freiburg I. Üe. 1928, Paris 1931. - Institutum Historicum FF. Praedicatorum, Dissertationes Historicae I.
Venetianische Depeschen	Venetianische Depeschen vom Kaiserhofe (Dispacci di Germania)		Venetianische Depeschen vom Kaiserhofe (Dispacci di Germania), hg. v. der Historischen Kommission der Kaiserlichen Akademie der Wissenschaften, 3 Bde., Wien 1889-1895.
Verzeichnis	Verzeichniß des Geschlechts der Bullinger und was sie der Kirche zu Bremgarten vergabet haben; verfaßt durch Heinrich Bullinger		Verzeichniß des Geschlechts der Bullinger und was sie der Kirche zu Bremgarten vergabet haben; verfaßt durch Heinrich Bullinger, den aͤltern, Pfarrer bei dem großen Münster in Zürich, im Jahr 1568, in Helvetia. Denkwürdigkeiten für die XXII Freistaaten der Schweizerischen Eidgenossenschaft, hg. V. Joseph Anton Balthasar, Bd. I., Zürich 1823, S. 91-112.
Verzeichnis	Aus dem "Verzeichnis des Geschlechts der Bullinger"		Emil Egli, Aus dem "Verzeichnis des Geschlechts der Bullinger", in: Zwa I 444-448.
Verzeichnis	Aus der Geschichte des Geschlechts der Bullinger von Bremgarten und Zürich (ausgestorben 1916)		F. O[tto] Pestalozzi, Aus der Geschichte des Geschlechts der Bullinger von Bremgarten und Zürich (ausgestorben 1916), in: ZTB 1930, NF, Jg. 50, S. 1-82.
Viglius van Zwichem	Des Viglius van Zwichem Tagebuch des Schmalkaldischen Donaukriegs		Des Viglius van Zwichem Tagebuch des Schmalkaldischen Donaukriegs, nach dem Autograph des Brüsseler Staatsarchivs hg. v. August von Druffel, München 1877.
Viénot	Histoire de la Réforme dans le pays de Montbéliard depuis les origines jusqu'à la mort de P. Toussain, 1524-1573		John Viénot, Histoire de la Réforme dans le pays de Montbéliard depuis les origines jusqu'à la mort de P. Toussain, 1524-1573, 2 Bde., Paris 1900.
Vogel	Das Zweite Regensburger Religionsgespräch von 1546. Politik und Theologie zwischen Konsensdruck und Selbstbehauptung		Lothar Vogel, Das Zweite Regensburger Religionsgespräch von 1546. Politik und Theologie zwischen Konsensdruck und Selbstbehauptung, Gütersloh 2009 - QFRG 82.
Voigt	Briefwechsel der berühmtesten Gelehrten mit Herzog Albrecht von Preußen		Johannes Voigt, Briefwechsel der berühmtesten Gelehrten mit Herzog Albrecht von Preußen, Königsberg 1841.
Voigt, Albrecht	Markgraf Albrecht Alcibiades von Brandenburg-Kulmbach		Johannes Voigt, Markgraf Albrecht Alcibiades von Brandenburg-Kulmbach, 2 Bde., Berlin 1852.
Voigt, Geschichtschr.	Die Geschichtschreibung über den Schmalkaldischen Krieg		Georg Voigt, Die Geschichtschreibung über den Schmalkaldischen Krieg, Leipzig 1874.
Voigt, Moritz	Moritz von Sachsen 1541-1547		Georg Voigt, Moritz von Sachsen 1541-1547, Leipzig 1876.
Volz, Urkunden	Urkunden und Aktenstücke zur Geschichte von Martin Luthers Schmalkaldischen Artikeln (1536-1574)		Urkunden und Aktenstücke zur Geschichte von Martin Luthers Schmalkaldischen Artikeln (1536-1574), unter Mitarbeit von Heinrich Ulbrich hg. u. erläutert von Hans Volz, Berlin 1957 - Kleine Texte für Vorlesungen und Übungen 179.
Von Stetten, Augsburg	Geschichte der Heil. Röm. Reichs Freyen Stadt Augsburg aus Bewährten Jahr-Büchern und Tüchtigen Urkunden gezogen und an das Licht gegeben		Paul von Stetten, Geschichte der Heil. Röm. Reichs Freyen Stadt Augsburg aus Bewährten Jahr-Büchern und Tüchtigen Urkunden gezogen und an das Licht gegeben, Frankfurt/Leipzig 1743.
Vorläufige Transkriptionen der HBBW-EditorInnen	(unveröffentlichte Transkriptionen)	0	Vorläufige Transkription der HBBW-EditorInnen
Vuilleumier	Histoire de l'Église Réformée du Pays de Vaud sous le Régime Bernois		Henri Vuilleumier, Histoire de l'Église Réformée du Pays de Vaud sous le Régime Bernois, Bd. I: L’Âge de la Réforme, Lausanne 1927.
Vögeli, Schriften	Schriften zur Reformation in Konstanz 1519-1538		Jörg Vögeli, Schriften zur Reformation in Konstanz 1519-1538, hg. v. Alfred Vögeli, 3 Bde., Tübingen/Basel 1972-1973 - SKRG 39-41.
Vögelin (Vögelin, Das alte Zürich)	Das alte Zürich		Salomon Vögelin, Das alte Zürich. Bd. I: Eine Wanderung durch Zürich im Jahr 1504, 2. umgearbeitete Aufl. v. Arnold Nüscheler und Friedrich Salomon Vögelin, Zürich 1878; Bd. II: Beiträge zur Geschichte der Stadt Zürich und ihrer Nachbargemeinden, hg. v. einer Vereinigung Zürcherischer Geschichtsfreunde, Zürich 1890; Register [zu Bd. 1] v. Friedrich Otto Pestalozzi, Zürich 1928.
WA	D. Martin Luthers Werke. Kritische Gesamtausgabe (Weimarer Ausgabe)		D. Martin Luthers Werke. Kritische Gesamtausgabe (Weimarer Ausgabe), Weimar u.a. 1883-2009.
WA-BW (WA Briefwechsel)	D. Martin Luthers Werke. Kritische Gesamtausgabe (WA), Briefwechsel		D. Martin Luthers Werke. Kritische Gesamtausgabe (WA), Briefwechsel, 18 Bde., Weimar 1930-1985.
WA-DB (WA DB)	D. Martin Luthers Werke. Kritische Gesamtausgabe (WA), Deutsche Bibel		D. Martin Luthers Werke. Kritische Gesamtausgabe (WA), Deutsche Bibel, 12 Bde., Weimar 1906-1961.
WA-TR (WA TR)	D. Martin Luthers Werke. Kritische Gesamtausgabe (WA), Tischreden		D. Martin Luthers Werke. Kritische Gesamtausgabe (WA), Tischreden, 6 Bde., Weimar 1912-1921.
Wagner, Fürstenberg	Graf Wilhelm von Fürstenberg, 1491-1549, und die politisch-geistigen Mächte seiner Zeit		Johannes Volker Wagner, Graf Wilhelm von Fürstenberg, 1491-1549, und die politisch-geistigen Mächte seiner Zeit, Stuttgart 1966 - Pariser Historische Studien 4.
Waitz, Lübeck	Lübeck unter Jürgen Wullenwever und die europäische Politik		Georg Waitz, Lübeck unter Jürgen Wullenwever und die europäische Politik, 3 Bde., Berlin 1855-1856.
Walch	Dr. Martin Luthers Sämtliche Schriften		Dr. Martin Luthers Sämtliche Schriften, hg. v. Johann Georg Walch, 2., überarb. Aufl., 23 Bde., St. Louis/Missouri 1880-1910 (Nachdruck: Groß Oesingen 1986).
Walliser Abschiede (Walliser Landrats-Abschiede)	Die Walliser Landrats-Abschiede seit dem Jahre 1500	3	Die Walliser Landrats-Abschiede seit dem Jahre 1500, hg. im Auftrage der Regierung des Kantons Wallis, Bd. 3 (1529-1547), bearb. v. Bernhard Truffer, Sitten 1973.
Walser	Die Prädestination bei Heinrich Bullinger im Zusammenhang mit seiner Gotteslehre		Peter Walser, Die Prädestination bei Heinrich Bullinger im Zusammenhang mit seiner Gotteslehre, Zürich 1957. - StDTh XI.
Walther	Carmina medii aevi posterioris Latina		Carmina medii aevi posterioris Latina, Bd. I/1: Initia carminum ac versuum medii aevi posterioris Latinorum. Alphabetisches Verzeichnis der Versanfänge mittellateinischer Dichtung, hg. v. Hans Walther, Göttingen 1959; Bd. I/2: Ergänzungen und Berichtigungen zu Bd. I/1, hg. v. Hans Walther, Göttigen 1969. Bd. II/1-6: Proverbia sententiaeque Latinitatis medii aevi. Lateinische Sprichwörter und Sentenzen des Mittelalters in alphabetischer Anordnung, hg. v. Hans Walther, Göttingen 1963-1969; Bd. II/7-9: Proverbia sententiaeque Latinitatis medii ac recentioris aevi. Nova series. Lateinische Sprichwörter und Sentenzen des Mittelalters und der frühen Neuzeit in alphabetischer Anordnung. Neue Reihe, hg. v. Paul Gerhard Schmidt, Göttingen 1982-1986.
Wander	Deutsches Sprichwörter-Lexikon. Ein Hausschatz für das deutsche Volk		Deutsches Sprichwörter-Lexikon. Ein Hausschatz für das deutsche Volk, hg. v. Karl Friedrich Wilhelm Wander, 5 Bde., Leipzig 1867-1880.
Warmbrunn	Zwei Konfessionen in einer Stadt. Das Zusammenleben von Katholiken und Protestanten in den paritätischen Reichsstädten Augsburg, Biberach, Ravensburg und Dinkelsbühl von 1548 bis 1648		Paul Warmbrunn, Zwei Konfessionen in einer Stadt. Das Zusammenleben von Katholiken und Protestanten in den paritätischen Reichsstädten Augsburg, Biberach, Ravensburg und Dinkelsbühl von 1548 bis 1648, Wiesbaden 1983 - Veröffentlichungen des Instituts für Europäische Geschichte Mainz, Abteilung für abendländische Religionsgeschichte 111.
Weber, Schwenck. (Weber, Schwenckfeld)	Kaspar Schwenckfeld und seine Anhänger in den freybergischen Herrschaften Justingen und Öpfingen. Ein Beitrag zur Reformationsgeschichte im Alb-Donau-Raum		Franz Michael Weber, Kaspar Schwenckfeld und seine Anhänger in den freybergischen Herrschaften Justingen und Öpfingen. Ein Beitrag zur Reformationsgeschichte im Alb-Donau-Raum, Stuttgart 1962 - Veröffentlichungen der Kommission für geschichtliche Landeskunde in Baden-Württemberg, Reihe B 19.
Weissenbach	Die Reformation in Bremgarten		Plazidus Weissenbach, Die Reformation in Bremgarten, in: Argovia. Jahresschrift der Historischen Gesellschaft des Kantons Aargau, Bd. VI, 1871, S. 1-125.
Weissmann	Die Einnahme Neuburgs im Schmalkaldischen Krieg 1546 und die "Schmach von Neuburg"		Albrecht Weissmann, Die Einnahme Neuburgs im Schmalkaldischen Krieg 1546 und die "Schmach von Neuburg", in: Neuburger Kollektaneenblatt 144, 1996, 110-121.
Weisz, Jud	Leo Jud, Ulrich Zwinglis Kampfgenosse		Leo Weisz, Leo Jud, Ulrich Zwinglis Kampfgenosse, 1482-1542, Zürich 1942.
Widmann, Chronik (Widmann)	Leonhart Widmann's Chronik von Regensburg		Leonhart Widmann's Chronik von Regensburg 1511-43. 1552-55, in: Die Chroniken der baierischen Städte. Regensburg. Landshut. Mühldorf. München, Leipzig 1878 - Die Chroniken der deutschen Städte vom 14. bis ins 16. Jahrhundert 15.
Wiggenhauser	Klerikale Karrieren. Das ländliche Chorherrenstift Embrach und seine Mitglieder im Mittelalter		Béatrice Wiggenhauser, Klerikale Karrieren. Das ländliche Chorherrenstift Embrach und seine Mitglieder im Mittelalter, Diss. phil. Zürich, Zürich 1997.
Wijnkoop Lüthi	Druckwerkeverzeichnis des Wolfgang Musculus (1497-1563)		Marc van Wijnkoop Lüthi, Druckwerkeverzeichnis des Wolfgang Musculus (1497-1563), in: Wolfgang Musculus (1497-1563) und die oberdeutsche Reformation, hg. v. Rudolf Dellsperger, Rudolf Freudenberger und Wolfgang Weber, Berlin 1997 - Institut für Europäische Kulturgeschichte der Universität Augsburg. Colloquia Augustana 6, S. 351-414.
Wille	Philipp der Großmüthige von Hessen und die Restitution Ulrichs von Wirtemberg 1526-1535		Jakob Wille, Philipp der Großmüthige von Hessen und die Restitution Ulrichs von Wirtemberg 1526-1535, Tübingen 1882.
Willem Klebitius	Bijdragen voor vaderlandsche geschiedenis en oudheidkunde	5	Nijhoff, Arnhem (1847) "Bijdragen voor Vaderlandsche Geschiedenis en Oudheidkunde. Vijfde Deel."
Winckelmann	Der Schmalkaldische Bund 1530-1532 und der Nürnberger Religionsfriede		Otto Winckelmann, Der Schmalkaldische Bund 1530-1532 und der Nürnberger Religionsfriede, Straßburg 1892.
Wipf, Schaffhausen (Wipf)	Reformationsgeschichte der Stadt und Landschaft Schaffhausen		Jakob Wipf, Reformationsgeschichte der Stadt und Landschaft Schaffhausen, Zürich 1929.
Wolrad, Augsburg	Des Grafen Wolrad von Waldeck Tagebuch während des Reichstages zu Augsburg 1548		Des Grafen Wolrad von Waldeck Tagebuch während des Reichstages zu Augsburg 1548, hg. von Carl Ludwig Philipp Tross, Stuttgart 1861.
Wolrad, Regensb. RG	Das Tagebuch des Grafen Wolrad II. zu Waldeck zum Regensburger Religionsgespräch, 1546		Victor Schultze, Das Tagebuch des Grafen Wolrad II. zu Waldeck zum Regensburger Religionsgespräch, 1546, in: ARG 7, 1909/10, 135-184. 294-347.
Wotschke	Der Briefwechsel der Schweizer mit den Polen		Der Briefwechsel der Schweizer mit den Polen, hg. v. Theodor Wotschke, Leipzig 1908 - ARG. Texte und Untersuchungen. Ergänzungsband 3.
Wyss, Chronik (Wyss)	Die Chronik des Bernhard Wyss		Die Chronik des Bernhard Wyss, 1519-1530, hg. v. Georg Finsler, Basel 1901 - QSRG 1.
Wyss, Jud	Leo Jud. Seine Entwicklung zum Reformator 1519-1523	61	Karl-Heinz Wyss, Leo Jud. Seine Entwicklung zum Reformator 1519-1523, Bern und Frankfurt a.M. 1976. - Europäische Hochschulschriften, Reihe III, Bd. 61.
Yoder I	Täufertum und Reformation in der Schweiz		John H. Yoder, Täufertum und Reformation in der Schweiz. I. Die Gespräche zwischen Täufern und Reformatoren 1523-1538, Karlsruhe 1962. - Schriftenreihe des Mennonitischen Geschichtsvereins, Nr. 6.
Yoder II	Täufertum und Reformation im Gespräch. Dogmengeschichtliche Untersuchung der frühen Gespräche zwischen Schweizerischen Täufern und Reformatoren		John H. Yoder, Täufertum und Reformation im Gespräch. Dogmengeschichtliche Untersuchung der frühen Gespräche zwischen Schweizerischen Täufern und Reformatoren, Zürich (1968). - Basler Studien zur historischen und systematischen Theologie, Bd. XIII.
Z	Huldreich Zwinglis sämtliche Werke		Huldreich Zwinglis sämtliche Werke, hg. v. Emil Egli, Georg Finsler, Walther Köhler u.a., 14 Bde., Berlin u.a. 1905-1991 - CR LXXXVIII-CI.
ZBRG	Zürcher Beiträge zur Reformationsgeschichte		Zürcher Beiträge zur Reformationsgeschichte, Zürich u.a. 1970ff.
ZED	Zürcher Einblattdrucke des 16. Jahrhunderts		Manfred Vischer, Zürcher Einblattdrucke des 16. Jahrhunderts, Baden-Baden 2001 - BBA 185.
ZGO	Zeitschrift für die Geschichte des Oberrheins		Zeitschrift für die Geschichte des Oberrheins, Karlsruhe 1850ff.
ZKG	Zeitschrift für Kirchengeschichte		Zeitschrift für Kirchengeschichte, Gotha/Stuttgart 1876ff.
ZSKG	Zeitschrift für Schweizerische Kirchengeschichte		Zeitschrift für Schweizerische Kirchengeschichte, Fribourg 1907-2003.
ZTB	Zürcher Taschenbuch		Zürcher Taschenbuch, NF 1ff, Zürich 1878ff.
ZUB	Urkundenbuch der Stadt und Landschaft Zürich		Urkundenbuch der Stadt und Landschaft Zürich, hg. v. einer Commission der antiquarischen Gesellschaft in Zürich, bearb. von Jakob Escher und Paul Schweizer, 13 Bde., Zürich 1888-1957.
ZWTh	Zeitschrift für Wissenschaftliche Theologie. Jena		Zeitschrift für Wissenschaftliche Theologie. Jena, Halle, Leipzig, Frankfurt a.M. 1858-1913.
Zedler	Großes vollständiges Universal-Lexicon aller Wissenschafften und Künste		Großes vollständiges Universal-Lexicon aller Wissenschafften und Künste, hg. v. Johann Heinrich Zedler und Johann Peter von Ludewig, 64 Bde. und 4 Erg.-Bde., Leipzig 1732-1754 (Online: http://www.zedler-lexikon.de/).
Zimmermann	Heinrich Bullingers schriftliche Arbeiten bis zum Jahr 1528. Eine bibliographische Untersuchung		Hans Georg Zimmermann, Heinrich Bullingers schriftliche Arbeiten bis zum Jahr 1528. Eine bibliographische Untersuchung, in: Zwa IX 220-239.
Zsindely	Heinrich Bullingers Berufungen im Jahre 1531		Endre Zsindely, Heinrich Bullingers Berufungen im Jahre 1531, in: Zwa XII 668-676.
Zurich Letters	The Zurich Letters		The Zurich Letters, comprising the correspondence of several English bishops and others, with some of the Helvetian reformers, during the reign of queen Elizabeth. Translated and edited by the Rev. Hastings Robinson, 2 Bde., Cambridge 1842/1845 (Nachdruck: New York/London 1968); second edition, chronologically arranged in one series, Cambridge 1846.
Zwa	Zwingliana		Zwingliana. Mitteilungen zur Geschichte Zwinglis und der Reformation (ab 1934: Beiträge zur Geschichte Zwinglis, der Reformation und des Protestantismus in der Schweiz; ab 2010: Beiträge zur Geschichte des Protestantismus in der Schweiz und seiner Ausstrahlung), Zürich 1897ff.
Zwingli Bibl. (Finsler)	Zwingli-Bibliographie		Georg Finsler, Zwingli-Bibliographie. Verzeichnis der gedruckten Schriften von und über Ulrich Zwingli, Zürich 1897.
Zürcher Kunst	Zürcher Kunst nach der Reformation. Hans Asper und seine Zeit. Katalog der Ausstellung im Helmhaus		Zürcher Kunst nach der Reformation. Hans Asper und seine Zeit. Katalog der Ausstellung im Helmhaus, Zürich 9. Mai bis 28. Juni 1981, Zürich 1981.
Zürcher, Pellikan (Zürcher)	Konrad Pellikans Wirken in Zürich 1526-1556		Christoph Zürcher, Konrad Pellikans Wirken in Zürich 1526-1556, Zürich 1975 - ZBRG 4.
ÖNB16 (Wien NB-16)	Katalog der Drucke des 16. Jahrhunderts in der Österreichischen Nationalbibliothek		Gedeon Borsa, Katalog der Drucke des 16. Jahrhunderts in der Österreichischen Nationalbibliothek, Baden-Baden 2007ff - Bibliotheca bibliographica Aureliana.